TATGTTTGAGCGACGCATTGGTGT -> ATGTTTGAGCGACGCATTGGTGTC
TGGGAGACGCCGGGATGGCCAGTG -> GGGAGACGCCGGGATGGCCAGTGG
CACCGCCTATGGAAAGCATTTGGC -> ACCGCCTATGGAAAGCATTTGGCT
TTCTAACAGGTCTCACTAACTGAG -> TCTAACAGGTCTCACTAACTGAGA
CAACCGCTCGTCTTAAGAAACCAG -> AACCGCTCGTCTTAAGAAACCAGC
TGATGGTTCACTCTTTGCCAGACT -> GATGGTTCACTCTTTGCCAGACTT
CGTTCTCAAAGGCACGTCGTGAAT -> GTTCTCAAAGGCACGTCGTGAATA
AATTCTCAGACGTTGTGAATTAGG -> ATTCTCAGACGTTGTGAATTAGGC
GCCGATATCATCAAGTGGTGAAAC -> CCGATATCATCAAGTGGTGAAACG
AGAAACCAGCGCATCGGCAAGCAA -> GAAACCAGCGCATCGGCAAGCAAC
ACTCGTGACTAGGTATCAGAAATT -> CTCGTGACTAGGTATCAGAAATTC
GTCGTGGCCAACCTCGTAAACTGC -> TCGTGGCCAACCTCGTAAACTGCC
ATTGAGTCTTCGAGCACTGTTACA -> TTGAGTCTTCGAGCACTGTTACAA
GCATCGGCAAGCAACGTTATATTA -> CATCGGCAAGCAACGTTATATTAT
AATGGGAGACGCCGGGATGGCCAG -> ATGGGAGACGCCGGGATGGCCAGT
ATATCACTATGTTTGAGCGACGCA -> TATCACTATGTTTGAGCGACGCAT
GCTTATACCACGGCGTGCCCGCGA -> CTTATACCACGGCGTGCCCGCGAG
CGTTCCTGGTCGTAACGGGCGGTT -> GTTCCTGGTCGTAACGGGCGGTTC
CGGGCGTCCCCATTAGTGTATGGA -> GGGCGTCCCCATTAGTGTATGGAA
CGTACAGTGAGGAACAATCGGGCG -> GTACAGTGAGGAACAATCGGGCGT
CGTGCACGTACAGTGAGGAACAAT -> GTGCACGTACAGTGAGGAACAATC
AGTATTCACCGACTAAGGATGTCA -> GTATTCACCGACTAAGGATGTCAA
TAACATGATTCGAGGGATGCTGGA -> AACATGATTCGAGGGATGCTGGAC
AACAGGTCTCACTAACTGAGACGT -> ACAGGTCTCACTAACTGAGACGTT
GGAGAGGGGTTGGAACGTTCCTGG -> GAGAGGGGTTGGAACGTTCCTGGT
TGTGAATTAGGCATCTCCGGACGA -> GTGAATTAGGCATCTCCGGACGAC
TTGTGAATTAGGCATCTCCGGACG -> TGTGAATTAGGCATCTCCGGACGA
CGTAGGGCGGACGTGTCTAGCCGT -> GTAGGGCGGACGTGTCTAGCCGTA
GGAGTTACGGACCTACAGACGGGT -> GAGTTACGGACCTACAGACGGGTC
TCACTCTGACATGTGCGGGTGGCT -> CACTCTGACATGTGCGGGTGGCTA
GTTCGCCGTTCTGCTGGTATTGGG -> TTCGCCGTTCTGCTGGTATTGGGC
GTACCTTCATACGATTTAATAGCG -> TACCTTCATACGATTTAATAGCGT
CGAAGGGAGCACCAACAATTTCCC -> GAAGGGAGCACCAACAATTTCCCC
CACTAACTGAGACGTTCTCAAAGG -> ACTAACTGAGACGTTCTCAAAGGC
ACTCGACCATCCGCCCAAATGTAG -> CTCGACCATCCGCCCAAATGTAGA
CCGGCAATAATGTGCGTGGTGCTT -> CGGCAATAATGTGCGTGGTGCTTC
TAGGCGCTGCATTAACGACGATAT -> AGGCGCTGCATTAACGACGATATA
TCGTAAACTGCCCAGACTTAAAAC -> CGTAAACTGCCCAGACTTAAAACC
AAGGAGAGAGGCAACAACCGCTCG -> AGGAGAGAGGCAACAACCGCTCGT
CTTAAGAAACCAGCGCATCGGCAA -> TTAAGAAACCAGCGCATCGGCAAG
TCCTTGATGCACCTAAATAGTGCG -> CCTTGATGCACCTAAATAGTGCGT
TCACTCTGGTACCATTCGCGCATT -> CACTCTGGTACCATTCGCGCATTG
ATGAGCCTTTAAGCAATTTACTTG -> TGAGCCTTTAAGCAATTTACTTGC
ACCTAAATAGTGCGTGAGATTTCG -> CCTAAATAGTGCGTGAGATTTCGT
GACCATCCGCCCAAATGTAGAACG -> ACCATCCGCCCAAATGTAGAACGA
CTTCCCTAGACCCGCACAACTAGG -> TTCCCTAGACCCGCACAACTAGGG
AAATGATGGACGTCATAGTCCGGT -> AATGATGGACGTCATAGTCCGGTG
GCAATTTACTTGCTCCATCCCCAT -> CAATTTACTTGCTCCATCCCCATC
GATGCTGGACGTAGGGCGGACGTG -> ATGCTGGACGTAGGGCGGACGTGT
CCATAGAAGTTGGGTATCAGGCGC -> CATAGAAGTTGGGTATCAGGCGCA
ATTAATCGCTTCCAAAGGCAGAAA -> TTAATCGCTTCCAAAGGCAGAAAT
TGTTGGCTCACGTACACTGAGTTG -> GTTGGCTCACGTACACTGAGTTGT
CTTATACCACGGCGTGCCCGCGAG -> TTATACCACGGCGTGCCCGCGAGA
GCTGAGGTAGGAAGCCTCGAAATT -> CTGAGGTAGGAAGCCTCGAAATTT
TACGGCAGCTTCCCTAGACCCGCA -> ACGGCAGCTTCCCTAGACCCGCAC
TATATCATAATACTGCGTTGCGAG -> ATATCATAATACTGCGTTGCGAGT
AGTGCAATGAGCCTTTAAGCAATT -> GTGCAATGAGCCTTTAAGCAATTT
TTTAAAGGAGAGAGGCAACAACCG -> TTAAAGGAGAGAGGCAACAACCGC
TGGAACGTTCCTGGTCGTAACGGG -> GGAACGTTCCTGGTCGTAACGGGC
TATACCACGGCGTGCCCGCGAGAA -> ATACCACGGCGTGCCCGCGAGAAG
GTCTGATGTTAATGAGTGAAATTC -> TCTGATGTTAATGAGTGAAATTCT
AAGCCTACTAATGTACGCAGGACG -> AGCCTACTAATGTACGCAGGACGA
TTTGAATTGCATATCACTATGTTT -> TTGAATTGCATATCACTATGTTTG
GATTCACGCAGCATCTCGAGCTAT -> ATTCACGCAGCATCTCGAGCTATG
TAGAGTCTGGGATAGAGTATTCAC -> AGAGTCTGGGATAGAGTATTCACC
GAAAGTTGGCGTATATCATAATAC -> AAAGTTGGCGTATATCATAATACT
CAGACTTGGTAGGCGTGTCATACA -> AGACTTGGTAGGCGTGTCATACAA
CCTCGTAAACTGCCCAGACTTAAA -> CTCGTAAACTGCCCAGACTTAAAA
GCGAATGATTTGCTATTGGCCATT -> CGAATGATTTGCTATTGGCCATTA
CGACCACTTGAGTCGACACATCAA -> GACCACTTGAGTCGACACATCAAG
ATTCCTGTGCTAGCGGCTTAAGTT -> TTCCTGTGCTAGCGGCTTAAGTTA
ACAACTAACTCGACCATCCGCCCA -> CAACTAACTCGACCATCCGCCCAA
GTACACTGAGTTGTAGGCGCTGCA -> TACACTGAGTTGTAGGCGCTGCAT
ATCTATATTAATAGTCCACTGCGC -> TCTATATTAATAGTCCACTGCGCC
ATTCGTGTCGTGGCCAACCTCGTA -> TTCGTGTCGTGGCCAACCTCGTAA
ATACTGCGTTGCGAGTCGGCTGAG -> TACTGCGTTGCGAGTCGGCTGAGG
AGAGGCAACAACCGCTCGTCTTAA -> GAGGCAACAACCGCTCGTCTTAAG
TGGTCGTAACGGGCGGTTCGCCTC -> GGTCGTAACGGGCGGTTCGCCTCG
GTATCAGGCGCACAGTGAAAAGCT -> TATCAGGCGCACAGTGAAAAGCTC
TCTAACAGGTCTCACTAACTGAGA -> CTAACAGGTCTCACTAACTGAGAC
GTAGAGTCTGGGATAGAGTATTCA -> TAGAGTCTGGGATAGAGTATTCAC
ATCATAATACTGCGTTGCGAGTCG -> TCATAATACTGCGTTGCGAGTCGG
TTCCTTGATGCACCTAAATAGTGC -> TCCTTGATGCACCTAAATAGTGCG
GTGCGTGAGATTTCGTGCACGTAC -> TGCGTGAGATTTCGTGCACGTACA
TCATAGTCCGGTGGGCACATCGCC -> CATAGTCCGGTGGGCACATCGCCA
AGACTTAAAACCAAGGCAAGGAAA -> GACTTAAAACCAAGGCAAGGAAAC
GAACAAGCAGGAAAAATCAGTAAT -> AACAAGCAGGAAAAATCAGTAATG
GGATAGAGTATTCACCGACTAAGG -> GATAGAGTATTCACCGACTAAGGA
ATACCACGGCGTGCCCGCGAGAAG -> TACCACGGCGTGCCCGCGAGAAGC
TGACTGACTCGTCCAAGGAAAATC -> GACTGACTCGTCCAAGGAAAATCT
TGTTCGACATTATAGGCTCTCCAG -> GTTCGACATTATAGGCTCTCCAGC
ACGACGATATATCGTGCCTCACTA -> CGACGATATATCGTGCCTCACTAG
GGCCAACCTCGTAAACTGCCCAGA -> GCCAACCTCGTAAACTGCCCAGAC
GACAACTAACTCGACCATCCGCCC -> ACAACTAACTCGACCATCCGCCCA
CATCGCCATAGAAGTTGGGTATCA -> ATCGCCATAGAAGTTGGGTATCAG
TGTCGTGGCCAACCTCGTAAACTG -> GTCGTGGCCAACCTCGTAAACTGC
GGCCATTAATCGCTTCCAAAGGCA -> GCCATTAATCGCTTCCAAAGGCAG
GGTCATTGCCGAGGGCTAACTTGT -> GTCATTGCCGAGGGCTAACTTGTT
ACGGAGAGGGGTTGGAACGTTCCT -> CGGAGAGGGGTTGGAACGTTCCTG
CCTAAATAGTGCGTGAGATTTCGT -> CTAAATAGTGCGTGAGATTTCGTG
TATATTAATAGTCCACTGCGCCTT -> ATATTAATAGTCCACTGCGCCTTG
TAATCGCTTCCAAAGGCAGAAATA -> AATCGCTTCCAAAGGCAGAAATAG
TCATACGATTTAATAGCGTAAAGA -> CATACGATTTAATAGCGTAAAGAC
ATGATTTGCTATTGGCCATTAATC -> TGATTTGCTATTGGCCATTAATCG
GCTTCCAGCAGCTACATGACTACG -> CTTCCAGCAGCTACATGACTACGG
CCAGCCCGGCAATAATGTGCGTGG -> CAGCCCGGCAATAATGTGCGTGGT
TTTTTATGATCTCGCATCATTCCT -> TTTTATGATCTCGCATCATTCCTG
ATGATCTCGCATCATTCCTGTGCT -> TGATCTCGCATCATTCCTGTGCTA
CCTTGTTGGAAACGGGGAAACCGG -> CTTGTTGGAAACGGGGAAACCGGC
CTCTTTGCCAGACTTGGTAGGCGT -> TCTTTGCCAGACTTGGTAGGCGTG
AATGTGCGTGGTGCTTCAAACGTC -> ATGTGCGTGGTGCTTCAAACGTCT
GTGTTTAAAGGAGAGAGGCAACAA -> TGTTTAAAGGAGAGAGGCAACAAC
TCAGAAATTCAGGCTGCTTCCAGC -> CAGAAATTCAGGCTGCTTCCAGCA
TCGAAGTTCGCCGTTCTGCTGGTA -> CGAAGTTCGCCGTTCTGCTGGTAT
ATTGGCCATTAATCGCTTCCAAAG -> TTGGCCATTAATCGCTTCCAAAGG
AACATCCTCCCTTTCCATAGTTCT -> ACATCCTCCCTTTCCATAGTTCTG
GATTACACTATACCAGTGCAATGA -> ATTACACTATACCAGTGCAATGAG
TCTGATGTTAATGAGTGAAATTCT -> CTGATGTTAATGAGTGAAATTCTC
AGTATAACATGATTCGAGGGATGC -> GTATAACATGATTCGAGGGATGCT
TGGTGCTTCAAACGTCTTACTTCG -> GGTGCTTCAAACGTCTTACTTCGA
GTTGGCGTATATCATAATACTGCG -> TTGGCGTATATCATAATACTGCGT
GTAGGCGCTGCATTAACGACGATA -> TAGGCGCTGCATTAACGACGATAT
ACTCGGCCTTCACTCTGACATGTG -> CTCGGCCTTCACTCTGACATGTGC
CTTGCTCCATCCCCATCAAATATA -> TTGCTCCATCCCCATCAAATATAT
GGCTGCTTCCAGCAGCTACATGAC -> GCTGCTTCCAGCAGCTACATGACT
CGTGTCGTGGCCAACCTCGTAAAC -> GTGTCGTGGCCAACCTCGTAAACT
GCACAATTCACTCTGGTACCATTC -> CACAATTCACTCTGGTACCATTCG
GCTGGTATTGGGCTTATACCACGG -> CTGGTATTGGGCTTATACCACGGC
TGTTTGATTGCCGATTCACGCAGC -> GTTTGATTGCCGATTCACGCAGCA
GGGGTCATTGCCGAGGGCTAACTT -> GGGTCATTGCCGAGGGCTAACTTG
TGTCATACAAGTCTTGCGTGACAC -> GTCATACAAGTCTTGCGTGACACC
TTCCAAAGGCAGAAATAGAACCGA -> TCCAAAGGCAGAAATAGAACCGAA
TAGGGAGTTACGGACCTACAGACG -> AGGGAGTTACGGACCTACAGACGG
TGAGTCGACACATCAAGCCTACTA -> GAGTCGACACATCAAGCCTACTAA
CCTCACTAGAACTATGACTGACTC -> CTCACTAGAACTATGACTGACTCG
TCCTGGTCGTAACGGGCGGTTCGC -> CCTGGTCGTAACGGGCGGTTCGCC
TAGAACTATGACTGACTCGTCCAA -> AGAACTATGACTGACTCGTCCAAG
CTAACTCGACCATCCGCCCAAATG -> TAACTCGACCATCCGCCCAAATGT
GGGCACATCGCCATAGAAGTTGGG -> GGCACATCGCCATAGAAGTTGGGT
TCGGGCGTCCCCATTAGTGTATGG -> CGGGCGTCCCCATTAGTGTATGGA
TATGGAAATATAGGATGTTGGCTC -> ATGGAAATATAGGATGTTGGCTCA
GTCATACAAGTCTTGCGTGACACC -> TCATACAAGTCTTGCGTGACACCG
GACTCGTCCAAGGAAAATCTGATT -> ACTCGTCCAAGGAAAATCTGATTC
CGCTCGTCTTAAGAAACCAGCGCA -> GCTCGTCTTAAGAAACCAGCGCAT
TCCCTTTCCATAGTTCTGGAAGGA -> CCCTTTCCATAGTTCTGGAAGGAG
TATCTTGATAGGGCACAGCAGGAC -> ATCTTGATAGGGCACAGCAGGACC
CGTGTATGACTCTGTTTGATTGCC -> GTGTATGACTCTGTTTGATTGCCG
CAACGTTATATTATCTTGATAGGG -> AACGTTATATTATCTTGATAGGGC
CGGCCTTCACTCTGACATGTGCGG -> GGCCTTCACTCTGACATGTGCGGG
GCACGTCGTGAATATTTCCTCTGG -> CACGTCGTGAATATTTCCTCTGGC
GTGGCCCTAGCCCAATTGTTCGAC -> TGGCCCTAGCCCAATTGTTCGACA
ATAGTCCGGTGGGCACATCGCCAT -> TAGTCCGGTGGGCACATCGCCATA
GTCAAAACGCCAATGCAAAGACTG -> TCAAAACGCCAATGCAAAGACTGG
ACCAACAATTTCCCCACTTTCTTT -> CCAACAATTTCCCCACTTTCTTTT
AGGGCGGACGTGTCTAGCCGTAGA -> GGGCGGACGTGTCTAGCCGTAGAA
TAATAACCTGTTCTACCCTAGCAT -> AATAACCTGTTCTACCCTAGCATT
GTGCTAGCGGCTTAAGTTAGGGTT -> TGCTAGCGGCTTAAGTTAGGGTTA
AAGGAAACAGGGACAGGGCCGTCG -> AGGAAACAGGGACAGGGCCGTCGC
CACGTACACTGAGTTGTAGGCGCT -> ACGTACACTGAGTTGTAGGCGCTG
CCTCGAAATTTTAGGAATGGTACC -> CTCGAAATTTTAGGAATGGTACCT
TTCGAGGGATGCTGGACGTAGGGC -> TCGAGGGATGCTGGACGTAGGGCG
TGGGCACATCGCCATAGAAGTTGG -> GGGCACATCGCCATAGAAGTTGGG
GCGCATTGAGTCTTCGAGCACTGT -> CGCATTGAGTCTTCGAGCACTGTT
ACTTCACAAGGTAATAACCTGTTC -> CTTCACAAGGTAATAACCTGTTCT
ATGTCAAAACGCCAATGCAAAGAC -> TGTCAAAACGCCAATGCAAAGACT
AAGAAACCAGCGCATCGGCAAGCA -> AGAAACCAGCGCATCGGCAAGCAA
CGTTGTGAATTAGGCATCTCCGGA -> GTTGTGAATTAGGCATCTCCGGAC
TTTATATGTGAAGTAGAGTCTGGG -> TTATATGTGAAGTAGAGTCTGGGA
GTTTGAGCGACGCATTGGTGTCTG -> TTTGAGCGACGCATTGGTGTCTGA
ATGGCCAGTGGCCCTAGCCCAATT -> TGGCCAGTGGCCCTAGCCCAATTG
CAAGTCTTGCGTGACACCGCCTCC -> AAGTCTTGCGTGACACCGCCTCCC
TGTATGGAAATATAGGATGTTGGC -> GTATGGAAATATAGGATGTTGGCT
ATTAATAGTCCACTGCGCCTTGTT -> TTAATAGTCCACTGCGCCTTGTTG
CCTAGACCCGCACAACTAGGGCGA -> CTAGACCCGCACAACTAGGGCGAG
GGACGTCATAGTCCGGTGGGCACA -> GACGTCATAGTCCGGTGGGCACAT
ACCTACAGACGGGTCAGTATAACA -> CCTACAGACGGGTCAGTATAACAT
GGCCGACGGGTAGGACTCGGCCTT -> GCCGACGGGTAGGACTCGGCCTTC
CCTTTTATATGTGAAGTAGAGTCT -> CTTTTATATGTGAAGTAGAGTCTG
GTATGGAAATATAGGATGTTGGCT -> TATGGAAATATAGGATGTTGGCTC
GTTAGATTAATGGGAGACGCCGGG -> TTAGATTAATGGGAGACGCCGGGA
AGTCGACACATCAAGCCTACTAAT -> GTCGACACATCAAGCCTACTAATG
TCACTAACTGAGACGTTCTCAAAG -> CACTAACTGAGACGTTCTCAAAGG
TACGGACCTACAGACGGGTCAGTA -> ACGGACCTACAGACGGGTCAGTAT
ACTGACTCGTCCAAGGAAAATCTG -> CTGACTCGTCCAAGGAAAATCTGA
CTTAAGTTAGGGTTAGATTAATGG -> TTAAGTTAGGGTTAGATTAATGGG
GTTTAAAGGAGAGAGGCAACAACC -> TTTAAAGGAGAGAGGCAACAACCG
GAGTCTTCGAGCACTGTTACAACG -> AGTCTTCGAGCACTGTTACAACGG
CGGCAAGCAACGTTATATTATCTT -> GGCAAGCAACGTTATATTATCTTG
CGTGGTGCTTCAAACGTCTTACTT -> GTGGTGCTTCAAACGTCTTACTTC
GCGACGCATTGGTGTCTGATGTTA -> CGACGCATTGGTGTCTGATGTTAA
CAACTAGGGCGAGTAACGGAACAA -> AACTAGGGCGAGTAACGGAACAAG
GACTCGGCCTTCACTCTGACATGT -> ACTCGGCCTTCACTCTGACATGTG
TCGCCTCGCACAATTCACTCTGGT -> CGCCTCGCACAATTCACTCTGGTA
ACAGGTCTCACTAACTGAGACGTT -> CAGGTCTCACTAACTGAGACGTTC
AACGGAACAAGCAGGAAAAATCAG -> ACGGAACAAGCAGGAAAAATCAGT
CCAGACTTAAAACCAAGGCAAGGA -> CAGACTTAAAACCAAGGCAAGGAA
CATTAATCGCTTCCAAAGGCAGAA -> ATTAATCGCTTCCAAAGGCAGAAA
AACAACCGCTCGTCTTAAGAAACC -> ACAACCGCTCGTCTTAAGAAACCA
AGCTTCGAAAGTTGGCGTATATCA -> GCTTCGAAAGTTGGCGTATATCAT
GAATGATTTGCTATTGGCCATTAA -> AATGATTTGCTATTGGCCATTAAT
AGACTTCACAAGGTAATAACCTGT -> GACTTCACAAGGTAATAACCTGTT
GCAGGACGAAATCTATATTAATAG -> CAGGACGAAATCTATATTAATAGT
ATCATTCCTGTGCTAGCGGCTTAA -> TCATTCCTGTGCTAGCGGCTTAAG
AAAATCAGTAATGATGGTTCACTC -> AAATCAGTAATGATGGTTCACTCT
TCATTCCTGTGCTAGCGGCTTAAG -> CATTCCTGTGCTAGCGGCTTAAGT
ATCTTGATAGGGCACAGCAGGACC -> TCTTGATAGGGCACAGCAGGACCC
AACGTCTTACTTCGAAGTTCGCCG -> ACGTCTTACTTCGAAGTTCGCCGT
TGCGTGACACCGCCTCCCTCGACA -> GCGTGACACCGCCTCCCTCGACAA
GTGTATGACTCTGTTTGATTGCCG -> TGTATGACTCTGTTTGATTGCCGA
GGTACCATTCGCGCATTGAGTCTT -> GTACCATTCGCGCATTGAGTCTTC
GGTTAGATTAATGGGAGACGCCGG -> GTTAGATTAATGGGAGACGCCGGG
ACGTACACTGAGTTGTAGGCGCTG -> CGTACACTGAGTTGTAGGCGCTGC
GGGTTAGATTAATGGGAGACGCCG -> GGTTAGATTAATGGGAGACGCCGG
TTACTTCGAAGTTCGCCGTTCTGC -> TACTTCGAAGTTCGCCGTTCTGCT
GTCTTCGAGCACTGTTACAACGGA -> TCTTCGAGCACTGTTACAACGGAT
TGGGCTTATACCACGGCGTGCCCG -> GGGCTTATACCACGGCGTGCCCGC
CCCTTTCCATAGTTCTGGAAGGAG -> CCTTTCCATAGTTCTGGAAGGAGT
TCACAAGGTAATAACCTGTTCTAC -> CACAAGGTAATAACCTGTTCTACC
ACGGGCGGTTCGCCTCGCACAATT -> CGGGCGGTTCGCCTCGCACAATTC
AATCCCTAGACTCGTGACTAGGTA -> ATCCCTAGACTCGTGACTAGGTAT
ATATATCACACTTATTGGGTGACC -> TATATCACACTTATTGGGTGACCA
GATTTAATAGCGTAAAGACTTCAC -> ATTTAATAGCGTAAAGACTTCACA
TTAGGGTTAGATTAATGGGAGACG -> TAGGGTTAGATTAATGGGAGACGC
TCACGCAGCATCTCGAGCTATGCG -> CACGCAGCATCTCGAGCTATGCGT
GCATTGAGTCTTCGAGCACTGTTA -> CATTGAGTCTTCGAGCACTGTTAC
TTGGTGAGTCATTCATAGGTACAA -> TGGTGAGTCATTCATAGGTACAAA
GCATTCGTGTCGTGGCCAACCTCG -> CATTCGTGTCGTGGCCAACCTCGT
TGACCACGGACGTGTATGACTCTG -> GACCACGGACGTGTATGACTCTGT
CTCGTGACTAGGTATCAGAAATTC -> TCGTGACTAGGTATCAGAAATTCA
TAAGCTTCGAAAGTTGGCGTATAT -> AAGCTTCGAAAGTTGGCGTATATC
TGCGTGAGATTTCGTGCACGTACA -> GCGTGAGATTTCGTGCACGTACAG
AGGATGTCAAAACGCCAATGCAAA -> GGATGTCAAAACGCCAATGCAAAG
ATTCTCAGACGTTGTGAATTAGGC -> TTCTCAGACGTTGTGAATTAGGCA
GAGGTAGGAAGCCTCGAAATTTTA -> AGGTAGGAAGCCTCGAAATTTTAG
TTGGCCATTAATCGCTTCCAAAGG -> TGGCCATTAATCGCTTCCAAAGGC
AGACGTTCTCAAAGGCACGTCGTG -> GACGTTCTCAAAGGCACGTCGTGA
AAAACGGAGAGGGGTTGGAACGTT -> AAACGGAGAGGGGTTGGAACGTTC
TTGTTGGAAACGGGGAAACCGGCC -> TGTTGGAAACGGGGAAACCGGCCG
TACTTCGAAGTTCGCCGTTCTGCT -> ACTTCGAAGTTCGCCGTTCTGCTG
GCGCGAATGATTTGCTATTGGCCA -> CGCGAATGATTTGCTATTGGCCAT
ACGTTCCTGGTCGTAACGGGCGGT -> CGTTCCTGGTCGTAACGGGCGGTT
CCATTAGTGTATGGAAATATAGGA -> CATTAGTGTATGGAAATATAGGAT
TACAAGTCTTGCGTGACACCGCCT -> ACAAGTCTTGCGTGACACCGCCTC
TTTGCCAGACTTGGTAGGCGTGTC -> TTGCCAGACTTGGTAGGCGTGTCA
GCGGCTTAAGTTAGGGTTAGATTA -> CGGCTTAAGTTAGGGTTAGATTAA
ACCAAGGCAAGGAAACAGGGACAG -> CCAAGGCAAGGAAACAGGGACAGG
TGGTTCACTCTTTGCCAGACTTGG -> GGTTCACTCTTTGCCAGACTTGGT
CGCATCATTCCTGTGCTAGCGGCT -> GCATCATTCCTGTGCTAGCGGCTT
AAGGCAGAAATAGAACCGAATCCC -> AGGCAGAAATAGAACCGAATCCCT
GGTGACCACGGACGTGTATGACTC -> GTGACCACGGACGTGTATGACTCT
TGGAAACGGGGAAACCGGCCGACG -> GGAAACGGGGAAACCGGCCGACGG
ACTGTTACAACGGATACCGCCTTG -> CTGTTACAACGGATACCGCCTTGC
TATCACTATGTTTGAGCGACGCAT -> ATCACTATGTTTGAGCGACGCATT
CCCATCAAATATATCACACTTATT -> CCATCAAATATATCACACTTATTG
ACGTGTCTAGCCGTAGAAATAAAT -> CGTGTCTAGCCGTAGAAATAAATG
TATGCGGGATGGGCACACCGCCTA -> ATGCGGGATGGGCACACCGCCTAT
ATTAGTGTATGGAAATATAGGATG -> TTAGTGTATGGAAATATAGGATGT
ATATCGTGCCTCACTAGAACTATG -> TATCGTGCCTCACTAGAACTATGA
CAGCGCATCGGCAAGCAACGTTAT -> AGCGCATCGGCAAGCAACGTTATA
CACATCAAGCCTACTAATGTACGC -> ACATCAAGCCTACTAATGTACGCA
GATTTGCTATTGGCCATTAATCGC -> ATTTGCTATTGGCCATTAATCGCT
ATCAGGCGCACAGTGAAAAGCTCC -> TCAGGCGCACAGTGAAAAGCTCCT
CAATAATTAGAACGTTGGTGAGTC -> AATAATTAGAACGTTGGTGAGTCA
ATTAATGGGAGACGCCGGGATGGC -> TTAATGGGAGACGCCGGGATGGCC
AGCAATTTACTTGCTCCATCCCCA -> GCAATTTACTTGCTCCATCCCCAT
GCACCTAAATAGTGCGTGAGATTT -> CACCTAAATAGTGCGTGAGATTTC
CTAGCCCAATTGTTCGACATTATA -> TAGCCCAATTGTTCGACATTATAG
CGAAAGTTGGCGTATATCATAATA -> GAAAGTTGGCGTATATCATAATAC
AGGGCACAGCAGGACCCGAAGGGA -> GGGCACAGCAGGACCCGAAGGGAG
GAGTTGTAGGCGCTGCATTAACGA -> AGTTGTAGGCGCTGCATTAACGAC
TTAGTGTATGGAAATATAGGATGT -> TAGTGTATGGAAATATAGGATGTT
ACACTATACCAGTGCAATGAGCCT -> CACTATACCAGTGCAATGAGCCTT
CCGGTGGGCACATCGCCATAGAAG -> CGGTGGGCACATCGCCATAGAAGT
CGTGTCATACAAGTCTTGCGTGAC -> GTGTCATACAAGTCTTGCGTGACA
GAGTATTCACCGACTAAGGATGTC -> AGTATTCACCGACTAAGGATGTCA
TCATGGGGTCATTGCCGAGGGCTA -> CATGGGGTCATTGCCGAGGGCTAA
AGGCAAGGAAACAGGGACAGGGCC -> GGCAAGGAAACAGGGACAGGGCCG
CGCACAACTAGGGCGAGTAACGGA -> GCACAACTAGGGCGAGTAACGGAA
GCCTCGAAATTTTAGGAATGGTAC -> CCTCGAAATTTTAGGAATGGTACC
TTATATGTGAAGTAGAGTCTGGGA -> TATATGTGAAGTAGAGTCTGGGAT
AGAACGAAAACGGAGAGGGGTTGG -> GAACGAAAACGGAGAGGGGTTGGA
AAGTCTTGCGTGACACCGCCTCCC -> AGTCTTGCGTGACACCGCCTCCCT
ACGTTGGTGAGTCATTCATAGGTA -> CGTTGGTGAGTCATTCATAGGTAC
ACGTCGTGAATATTTCCTCTGGCG -> CGTCGTGAATATTTCCTCTGGCGA
AGTCATTCATAGGTACAAAACATC -> GTCATTCATAGGTACAAAACATCC
CGGTTAGATACACATAGGGAGTTA -> GGTTAGATACACATAGGGAGTTAC
CTGAGACGTTCTCAAAGGCACGTC -> TGAGACGTTCTCAAAGGCACGTCG
TCGAGCACTGTTACAACGGATACC -> CGAGCACTGTTACAACGGATACCG
CAGAAATAGAACCGAATCCCTAGA -> AGAAATAGAACCGAATCCCTAGAC
CGGCTTAAGTTAGGGTTAGATTAA -> GGCTTAAGTTAGGGTTAGATTAAT
CTCTGGCGATTACACTATACCAGT -> TCTGGCGATTACACTATACCAGTG
GCCTTGTTGGAAACGGGGAAACCG -> CCTTGTTGGAAACGGGGAAACCGG
AGAAATAGAACCGAATCCCTAGAC -> GAAATAGAACCGAATCCCTAGACT
GACCACTTGAGTCGACACATCAAG -> ACCACTTGAGTCGACACATCAAGC
GACTCTGTTTGATTGCCGATTCAC -> ACTCTGTTTGATTGCCGATTCACG
GCGCACAGTGAAAAGCTCCTTTTA -> CGCACAGTGAAAAGCTCCTTTTAT
AAAGGCAGAAATAGAACCGAATCC -> AAGGCAGAAATAGAACCGAATCCC
ACAACCGCTCGTCTTAAGAAACCA -> CAACCGCTCGTCTTAAGAAACCAG
CGAATGATTTGCTATTGGCCATTA -> GAATGATTTGCTATTGGCCATTAA
TAGTTCTGGAAGGAGTGTTTAAAG -> AGTTCTGGAAGGAGTGTTTAAAGG
TCTGGAAGGAGTGTTTAAAGGAGA -> CTGGAAGGAGTGTTTAAAGGAGAG
AGAAATTCAGGCTGCTTCCAGCAG -> GAAATTCAGGCTGCTTCCAGCAGC
TCGACCATCCGCCCAAATGTAGAA -> CGACCATCCGCCCAAATGTAGAAC
TAGATTAATGGGAGACGCCGGGAT -> AGATTAATGGGAGACGCCGGGATG
TTCTCAGACGTTGTGAATTAGGCA -> TCTCAGACGTTGTGAATTAGGCAT
TACAACGGATACCGCCTTGCATTC -> ACAACGGATACCGCCTTGCATTCG
CTACTAATGTACGCAGGACGAAAT -> TACTAATGTACGCAGGACGAAATC
ACTATGTTTGAGCGACGCATTGGT -> CTATGTTTGAGCGACGCATTGGTG
CTCAGACGTTGTGAATTAGGCATC -> TCAGACGTTGTGAATTAGGCATCT
GTGCCTCACTAGAACTATGACTGA -> TGCCTCACTAGAACTATGACTGAC
GCTGCTTCCAGCAGCTACATGACT -> CTGCTTCCAGCAGCTACATGACTA
TTCGAAGTTCGCCGTTCTGCTGGT -> TCGAAGTTCGCCGTTCTGCTGGTA
TTCACAAGGTAATAACCTGTTCTA -> TCACAAGGTAATAACCTGTTCTAC
TTACAACGGATACCGCCTTGCATT -> TACAACGGATACCGCCTTGCATTC
AGAACGTTGGTGAGTCATTCATAG -> GAACGTTGGTGAGTCATTCATAGG
TGCCGAGGGCTAACTTGTTTTGAA -> GCCGAGGGCTAACTTGTTTTGAAT
GAGCACTGTTACAACGGATACCGC -> AGCACTGTTACAACGGATACCGCC
CCTTGCATTCGTGTCGTGGCCAAC -> CTTGCATTCGTGTCGTGGCCAACC
CAAGCAACGTTATATTATCTTGAT -> AAGCAACGTTATATTATCTTGATA
CCCGGCAATAATGTGCGTGGTGCT -> CCGGCAATAATGTGCGTGGTGCTT
CCGCCTCCCTCGACAACTAACTCG -> CGCCTCCCTCGACAACTAACTCGA
TAATAGTCCACTGCGCCTTGTTGG -> AATAGTCCACTGCGCCTTGTTGGA
TTGCGAGTCGGCTGAGGTAGGAAG -> TGCGAGTCGGCTGAGGTAGGAAGC
CGGTTTCTAACAGGTCTCACTAAC -> GGTTTCTAACAGGTCTCACTAACT
AGGCGTGTCATACAAGTCTTGCGT -> GGCGTGTCATACAAGTCTTGCGTG
GGTTGGAACGTTCCTGGTCGTAAC -> GTTGGAACGTTCCTGGTCGTAACG
ATGTTTGAGCGACGCATTGGTGTC -> TGTTTGAGCGACGCATTGGTGTCT
TTATATTATCTTGATAGGGCACAG -> TATATTATCTTGATAGGGCACAGC
ACCACGGACGTGTATGACTCTGTT -> CCACGGACGTGTATGACTCTGTTT
GAACGTTGGTGAGTCATTCATAGG -> AACGTTGGTGAGTCATTCATAGGT
TGATTTGCTATTGGCCATTAATCG -> GATTTGCTATTGGCCATTAATCGC
AAAGCATTTGGCTTCCTTGATGCA -> AAGCATTTGGCTTCCTTGATGCAC
ACGTCTTACTTCGAAGTTCGCCGT -> CGTCTTACTTCGAAGTTCGCCGTT
CGTGAATATTTCCTCTGGCGATTA -> GTGAATATTTCCTCTGGCGATTAC
TGGCTTCCTTGATGCACCTAAATA -> GGCTTCCTTGATGCACCTAAATAG
CTCCAGCCCGGCAATAATGTGCGT -> TCCAGCCCGGCAATAATGTGCGTG
CGCTTCCAAAGGCAGAAATAGAAC -> GCTTCCAAAGGCAGAAATAGAACC
ACGTTATATTATCTTGATAGGGCA -> CGTTATATTATCTTGATAGGGCAC
GGCCTTCACTCTGACATGTGCGGG -> GCCTTCACTCTGACATGTGCGGGT
TCTACCCTAGCATTTGCGGTTAGA -> CTACCCTAGCATTTGCGGTTAGAT
GGCTTCCTTGATGCACCTAAATAG -> GCTTCCTTGATGCACCTAAATAGT
CATCAAGCCTACTAATGTACGCAG -> ATCAAGCCTACTAATGTACGCAGG
CCCCATTAGTGTATGGAAATATAG -> CCCATTAGTGTATGGAAATATAGG
AAAACGCCAATGCAAAGACTGGGG -> AAACGCCAATGCAAAGACTGGGGA
ACCTGTTCTACCCTAGCATTTGCG -> CCTGTTCTACCCTAGCATTTGCGG
TAAGCGCGAATGATTTGCTATTGG -> AAGCGCGAATGATTTGCTATTGGC
CAATTTCCCCACTTTCTTTTCATG -> AATTTCCCCACTTTCTTTTCATGG
ATAACCTGTTCTACCCTAGCATTT -> TAACCTGTTCTACCCTAGCATTTG
GACGTAGGGCGGACGTGTCTAGCC -> ACGTAGGGCGGACGTGTCTAGCCG
ATCAAGCCTACTAATGTACGCAGG -> TCAAGCCTACTAATGTACGCAGGA
GCTGGACGTAGGGCGGACGTGTCT -> CTGGACGTAGGGCGGACGTGTCTA
GACCTACAGACGGGTCAGTATAAC -> ACCTACAGACGGGTCAGTATAACA
GCATATCACTATGTTTGAGCGACG -> CATATCACTATGTTTGAGCGACGC
GTTAGATACACATAGGGAGTTACG -> TTAGATACACATAGGGAGTTACGG
ACTAGGTATCAGAAATTCAGGCTG -> CTAGGTATCAGAAATTCAGGCTGC
GCAGGACCCGAAGGGAGCACCAAC -> CAGGACCCGAAGGGAGCACCAACA
TTAATGGGAGACGCCGGGATGGCC -> TAATGGGAGACGCCGGGATGGCCA
TATGGAAAGCATTTGGCTTCCTTG -> ATGGAAAGCATTTGGCTTCCTTGA
GAGGCAACAACCGCTCGTCTTAAG -> AGGCAACAACCGCTCGTCTTAAGA
CCTGGTCGTAACGGGCGGTTCGCC -> CTGGTCGTAACGGGCGGTTCGCCT
CCAGTGCAATGAGCCTTTAAGCAA -> CAGTGCAATGAGCCTTTAAGCAAT
TCAAATATATCACACTTATTGGGT -> CAAATATATCACACTTATTGGGTG
GGGCGGTTCGCCTCGCACAATTCA -> GGCGGTTCGCCTCGCACAATTCAC
CACATCGCCATAGAAGTTGGGTAT -> ACATCGCCATAGAAGTTGGGTATC
ACTTATTGGGTGACCACGGACGTG -> CTTATTGGGTGACCACGGACGTGT
TTGTTTTGAATTGCATATCACTAT -> TGTTTTGAATTGCATATCACTATG
GACGAAATCTATATTAATAGTCCA -> ACGAAATCTATATTAATAGTCCAC
CAATCGGGCGTCCCCATTAGTGTA -> AATCGGGCGTCCCCATTAGTGTAT
AGGACCCGAAGGGAGCACCAACAA -> GGACCCGAAGGGAGCACCAACAAT
GAAACGTTTTTATGATCTCGCATC -> AAACGTTTTTATGATCTCGCATCA
TCGAAATTTTAGGAATGGTACCTT -> CGAAATTTTAGGAATGGTACCTTC
ACAAGGTAATAACCTGTTCTACCC -> CAAGGTAATAACCTGTTCTACCCT
TCTCAAAGGCACGTCGTGAATATT -> CTCAAAGGCACGTCGTGAATATTT
TGCACCTAAATAGTGCGTGAGATT -> GCACCTAAATAGTGCGTGAGATTT
CGTTGGTGAGTCATTCATAGGTAC -> GTTGGTGAGTCATTCATAGGTACA
ACGCCGGGATGGCCAGTGGCCCTA -> CGCCGGGATGGCCAGTGGCCCTAG
GCGCATCGGCAAGCAACGTTATAT -> CGCATCGGCAAGCAACGTTATATT
TTTAATAGCGTAAAGACTTCACAA -> TTAATAGCGTAAAGACTTCACAAG
AACGGGGAAACCGGCCGACGGGTA -> ACGGGGAAACCGGCCGACGGGTAG
GGTAATAACCTGTTCTACCCTAGC -> GTAATAACCTGTTCTACCCTAGCA
CTATGACTGACTCGTCCAAGGAAA -> TATGACTGACTCGTCCAAGGAAAA
GTGACACCGCCTCCCTCGACAACT -> TGACACCGCCTCCCTCGACAACTA
TCTCGAGCTATGCGTATAAGCGCG -> CTCGAGCTATGCGTATAAGCGCGA
TAATGATGGTTCACTCTTTGCCAG -> AATGATGGTTCACTCTTTGCCAGA
CAGCTTCCCTAGACCCGCACAACT -> AGCTTCCCTAGACCCGCACAACTA
TAGATACACATAGGGAGTTACGGA -> AGATACACATAGGGAGTTACGGAC
CTAACAGGTCTCACTAACTGAGAC -> TAACAGGTCTCACTAACTGAGACG
CTAACTTGTTTTGAATTGCATATC -> TAACTTGTTTTGAATTGCATATCA
CCGCTCGTCTTAAGAAACCAGCGC -> CGCTCGTCTTAAGAAACCAGCGCA
CACTTTCTTTTCATGGGGTCATTG -> ACTTTCTTTTCATGGGGTCATTGC
TTTGCTATTGGCCATTAATCGCTT -> TTGCTATTGGCCATTAATCGCTTC
CCTCGACAACTAACTCGACCATCC -> CTCGACAACTAACTCGACCATCCG
GTTTTTATGATCTCGCATCATTCC -> TTTTTATGATCTCGCATCATTCCT
CGGACGTGTCTAGCCGTAGAAATA -> GGACGTGTCTAGCCGTAGAAATAA
ATAGGGAGTTACGGACCTACAGAC -> TAGGGAGTTACGGACCTACAGACG
GCTCGTCTTAAGAAACCAGCGCAT -> CTCGTCTTAAGAAACCAGCGCATC
CTTCACTCTGACATGTGCGGGTGG -> TTCACTCTGACATGTGCGGGTGGC
AATGGTACCTTCATACGATTTAAT -> ATGGTACCTTCATACGATTTAATA
GCCTTTAAGCAATTTACTTGCTCC -> CCTTTAAGCAATTTACTTGCTCCA
TGCTTCCAGCAGCTACATGACTAC -> GCTTCCAGCAGCTACATGACTACG
TTATACCACGGCGTGCCCGCGAGA -> TATACCACGGCGTGCCCGCGAGAA
TGGACGTAGGGCGGACGTGTCTAG -> GGACGTAGGGCGGACGTGTCTAGC
CTGAGTTGTAGGCGCTGCATTAAC -> TGAGTTGTAGGCGCTGCATTAACG
CACCGCCTCCCTCGACAACTAACT -> ACCGCCTCCCTCGACAACTAACTC
TAGAACGTTGGTGAGTCATTCATA -> AGAACGTTGGTGAGTCATTCATAG
GTCTCACTAACTGAGACGTTCTCA -> TCTCACTAACTGAGACGTTCTCAA
GCGATTACACTATACCAGTGCAAT -> CGATTACACTATACCAGTGCAATG
ACAACTAGGGCGAGTAACGGAACA -> CAACTAGGGCGAGTAACGGAACAA
CGGTGGGCACATCGCCATAGAAGT -> GGTGGGCACATCGCCATAGAAGTT
CGTGTCTAGCCGTAGAAATAAATG -> GTGTCTAGCCGTAGAAATAAATGA
TTGATGCACCTAAATAGTGCGTGA -> TGATGCACCTAAATAGTGCGTGAG
ATCATCAAGTGGTGAAACGTTTTT -> TCATCAAGTGGTGAAACGTTTTTA
AAATTCAGGCTGCTTCCAGCAGCT -> AATTCAGGCTGCTTCCAGCAGCTA
CGATTACACTATACCAGTGCAATG -> GATTACACTATACCAGTGCAATGA
TTCGAGCACTGTTACAACGGATAC -> TCGAGCACTGTTACAACGGATACC
TGAGACGTTCTCAAAGGCACGTCG -> GAGACGTTCTCAAAGGCACGTCGT
ATCAAATATATCACACTTATTGGG -> TCAAATATATCACACTTATTGGGT
GGGTCATTGCCGAGGGCTAACTTG -> GGTCATTGCCGAGGGCTAACTTGT
TCCCCACTTTCTTTTCATGGGGTC -> CCCCACTTTCTTTTCATGGGGTCA
CGGGTGGCTAAGCTTCGAAAGTTG -> GGGTGGCTAAGCTTCGAAAGTTGG
ATAAATGATGGACGTCATAGTCCG -> TAAATGATGGACGTCATAGTCCGG
ACGGGTAGGACTCGGCCTTCACTC -> CGGGTAGGACTCGGCCTTCACTCT
GTCTTGCGTGACACCGCCTCCCTC -> TCTTGCGTGACACCGCCTCCCTCG
CGTGGCCAACCTCGTAAACTGCCC -> GTGGCCAACCTCGTAAACTGCCCA
TCCAGCAGCTACATGACTACGGCA -> CCAGCAGCTACATGACTACGGCAG
TTCACTCTGACATGTGCGGGTGGC -> TCACTCTGACATGTGCGGGTGGCT
CCGAATCCCTAGACTCGTGACTAG -> CGAATCCCTAGACTCGTGACTAGG
CCGCACAACTAGGGCGAGTAACGG -> CGCACAACTAGGGCGAGTAACGGA
TAAGAAACCAGCGCATCGGCAAGC -> AAGAAACCAGCGCATCGGCAAGCA
TACACTATACCAGTGCAATGAGCC -> ACACTATACCAGTGCAATGAGCCT
GGACCTACAGACGGGTCAGTATAA -> GACCTACAGACGGGTCAGTATAAC
GTGCCCGCGAGAAGCAATAATTAG -> TGCCCGCGAGAAGCAATAATTAGA
GTAGAAATAAATGATGGACGTCAT -> TAGAAATAAATGATGGACGTCATA
TAGGGCGAGTAACGGAACAAGCAG -> AGGGCGAGTAACGGAACAAGCAGG
CTTCACAAGGTAATAACCTGTTCT -> TTCACAAGGTAATAACCTGTTCTA
TGTACGCAGGACGAAATCTATATT -> GTACGCAGGACGAAATCTATATTA
AGGTACAAAACATCCTCCCTTTCC -> GGTACAAAACATCCTCCCTTTCCA
AGGGAGCACCAACAATTTCCCCAC -> GGGAGCACCAACAATTTCCCCACT
AGGAATGGTACCTTCATACGATTT -> GGAATGGTACCTTCATACGATTTA
TAACAGGTCTCACTAACTGAGACG -> AACAGGTCTCACTAACTGAGACGT
CTTAAAACCAAGGCAAGGAAACAG -> TTAAAACCAAGGCAAGGAAACAGG
ATAGCGTAAAGACTTCACAAGGTA -> TAGCGTAAAGACTTCACAAGGTAA
AGACGCCGGGATGGCCAGTGGCCC -> GACGCCGGGATGGCCAGTGGCCCT
GTATTGGGCTTATACCACGGCGTG -> TATTGGGCTTATACCACGGCGTGC
CTCGGCCTTCACTCTGACATGTGC -> TCGGCCTTCACTCTGACATGTGCG
CGTCTTAAGAAACCAGCGCATCGG -> GTCTTAAGAAACCAGCGCATCGGC
CGACATTATAGGCTCTCCAGCCCG -> GACATTATAGGCTCTCCAGCCCGG
AGAACTATGACTGACTCGTCCAAG -> GAACTATGACTGACTCGTCCAAGG
GGCACACCGCCTATGGAAAGCATT -> GCACACCGCCTATGGAAAGCATTT
GTTAGGGTTAGATTAATGGGAGAC -> TTAGGGTTAGATTAATGGGAGACG
TACTAATGTACGCAGGACGAAATC -> ACTAATGTACGCAGGACGAAATCT
CGCCGATATCATCAAGTGGTGAAA -> GCCGATATCATCAAGTGGTGAAAC
GAAGTTGGGTATCAGGCGCACAGT -> AAGTTGGGTATCAGGCGCACAGTG
AGCGCGAATGATTTGCTATTGGCC -> GCGCGAATGATTTGCTATTGGCCA
CGGACCTACAGACGGGTCAGTATA -> GGACCTACAGACGGGTCAGTATAA
GGTCAGTATAACATGATTCGAGGG -> GTCAGTATAACATGATTCGAGGGA
ATCAGAAATTCAGGCTGCTTCCAG -> TCAGAAATTCAGGCTGCTTCCAGC
AGTCTTGCGTGACACCGCCTCCCT -> GTCTTGCGTGACACCGCCTCCCTC
GGGCACAGCAGGACCCGAAGGGAG -> GGCACAGCAGGACCCGAAGGGAGC
CATAGTTCTGGAAGGAGTGTTTAA -> ATAGTTCTGGAAGGAGTGTTTAAA
ACCGACTAAGGATGTCAAAACGCC -> CCGACTAAGGATGTCAAAACGCCA
CGAAAACGGAGAGGGGTTGGAACG -> GAAAACGGAGAGGGGTTGGAACGT
AACCAAGGCAAGGAAACAGGGACA -> ACCAAGGCAAGGAAACAGGGACAG
TATTGGGCTTATACCACGGCGTGC -> ATTGGGCTTATACCACGGCGTGCC
GGGCGAGTAACGGAACAAGCAGGA -> GGCGAGTAACGGAACAAGCAGGAA
TCAAACGTCTTACTTCGAAGTTCG -> CAAACGTCTTACTTCGAAGTTCGC
ACAGGGCCGTCGCCGATATCATCA -> CAGGGCCGTCGCCGATATCATCAA
TACCGCCTTGCATTCGTGTCGTGG -> ACCGCCTTGCATTCGTGTCGTGGC
AATGATTTGCTATTGGCCATTAAT -> ATGATTTGCTATTGGCCATTAATC
GTAACGGGCGGTTCGCCTCGCACA -> TAACGGGCGGTTCGCCTCGCACAA
TATCGTGCCTCACTAGAACTATGA -> ATCGTGCCTCACTAGAACTATGAC
TTTTAGGAATGGTACCTTCATACG -> TTTAGGAATGGTACCTTCATACGA
TCCATCCCCATCAAATATATCACA -> CCATCCCCATCAAATATATCACAC
CTTCCTTGATGCACCTAAATAGTG -> TTCCTTGATGCACCTAAATAGTGC
GGTCGTAACGGGCGGTTCGCCTCG -> GTCGTAACGGGCGGTTCGCCTCGC
ACGGACCTACAGACGGGTCAGTAT -> CGGACCTACAGACGGGTCAGTATA
ATGTGAAGTAGAGTCTGGGATAGA -> TGTGAAGTAGAGTCTGGGATAGAG
GGAATGGTACCTTCATACGATTTA -> GAATGGTACCTTCATACGATTTAA
GCTCTCCAGCCCGGCAATAATGTG -> CTCTCCAGCCCGGCAATAATGTGC
GACGTGTCTAGCCGTAGAAATAAA -> ACGTGTCTAGCCGTAGAAATAAAT
ATACACATAGGGAGTTACGGACCT -> TACACATAGGGAGTTACGGACCTA
TTCTACCCTAGCATTTGCGGTTAG -> TCTACCCTAGCATTTGCGGTTAGA
TTAATCGCTTCCAAAGGCAGAAAT -> TAATCGCTTCCAAAGGCAGAAATA
ACGTTGTGAATTAGGCATCTCCGG -> CGTTGTGAATTAGGCATCTCCGGA
AGCTTCCCTAGACCCGCACAACTA -> GCTTCCCTAGACCCGCACAACTAG
CCGGGATGGCCAGTGGCCCTAGCC -> CGGGATGGCCAGTGGCCCTAGCCC
CTTGCGTGACACCGCCTCCCTCGA -> TTGCGTGACACCGCCTCCCTCGAC
GTGACTAGGTATCAGAAATTCAGG -> TGACTAGGTATCAGAAATTCAGGC
TAGGTATCAGAAATTCAGGCTGCT -> AGGTATCAGAAATTCAGGCTGCTT
AACCGCTCGTCTTAAGAAACCAGC -> ACCGCTCGTCTTAAGAAACCAGCG
TGATGCACCTAAATAGTGCGTGAG -> GATGCACCTAAATAGTGCGTGAGA
GTATGACTCTGTTTGATTGCCGAT -> TATGACTCTGTTTGATTGCCGATT
ACCCGAAGGGAGCACCAACAATTT -> CCCGAAGGGAGCACCAACAATTTC
GAGATTTCGTGCACGTACAGTGAG -> AGATTTCGTGCACGTACAGTGAGG
GCCAGACTTGGTAGGCGTGTCATA -> CCAGACTTGGTAGGCGTGTCATAC
ATGTGCGTGGTGCTTCAAACGTCT -> TGTGCGTGGTGCTTCAAACGTCTT
TATAGGATGTTGGCTCACGTACAC -> ATAGGATGTTGGCTCACGTACACT
GTGGCCAACCTCGTAAACTGCCCA -> TGGCCAACCTCGTAAACTGCCCAG
ATCCCTAGACTCGTGACTAGGTAT -> TCCCTAGACTCGTGACTAGGTATC
CTTGCATTCGTGTCGTGGCCAACC -> TTGCATTCGTGTCGTGGCCAACCT
TGCGTATAAGCGCGAATGATTTGC -> GCGTATAAGCGCGAATGATTTGCT
CCGCCCAAATGTAGAACGAAAACG -> CGCCCAAATGTAGAACGAAAACGG
CAATTCACTCTGGTACCATTCGCG -> AATTCACTCTGGTACCATTCGCGC
CGTAACGGGCGGTTCGCCTCGCAC -> GTAACGGGCGGTTCGCCTCGCACA
TCACTCTTTGCCAGACTTGGTAGG -> CACTCTTTGCCAGACTTGGTAGGC
AACAAGCAGGAAAAATCAGTAATG -> ACAAGCAGGAAAAATCAGTAATGA
CTTGATAGGGCACAGCAGGACCCG -> TTGATAGGGCACAGCAGGACCCGA
AGGCACGTCGTGAATATTTCCTCT -> GGCACGTCGTGAATATTTCCTCTG
TGGAAAGCATTTGGCTTCCTTGAT -> GGAAAGCATTTGGCTTCCTTGATG
TGTGAAGTAGAGTCTGGGATAGAG -> GTGAAGTAGAGTCTGGGATAGAGT
AAAGGAGAGAGGCAACAACCGCTC -> AAGGAGAGAGGCAACAACCGCTCG
AGTCCGGTGGGCACATCGCCATAG -> GTCCGGTGGGCACATCGCCATAGA
GGGAGACGCCGGGATGGCCAGTGG -> GGAGACGCCGGGATGGCCAGTGGC
TTGGAACGTTCCTGGTCGTAACGG -> TGGAACGTTCCTGGTCGTAACGGG
AGGTCTCACTAACTGAGACGTTCT -> GGTCTCACTAACTGAGACGTTCTC
TCTGCTGGTATTGGGCTTATACCA -> CTGCTGGTATTGGGCTTATACCAC
GGATGGGCACACCGCCTATGGAAA -> GATGGGCACACCGCCTATGGAAAG
AGACCCGCACAACTAGGGCGAGTA -> GACCCGCACAACTAGGGCGAGTAA
CCTTTAAGCAATTTACTTGCTCCA -> CTTTAAGCAATTTACTTGCTCCAT
AGGGGTTGGAACGTTCCTGGTCGT -> GGGGTTGGAACGTTCCTGGTCGTA
CCCGCACAACTAGGGCGAGTAACG -> CCGCACAACTAGGGCGAGTAACGG
TGCGGTTAGATACACATAGGGAGT -> GCGGTTAGATACACATAGGGAGTT
GACTGACTCGTCCAAGGAAAATCT -> ACTGACTCGTCCAAGGAAAATCTG
ATGATGGTTCACTCTTTGCCAGAC -> TGATGGTTCACTCTTTGCCAGACT
AAAATCTGATTCGCGCGGTTTCTA -> AAATCTGATTCGCGCGGTTTCTAA
GTTGGGTATCAGGCGCACAGTGAA -> TTGGGTATCAGGCGCACAGTGAAA
ACTAATGTACGCAGGACGAAATCT -> CTAATGTACGCAGGACGAAATCTA
AGCATTTGGCTTCCTTGATGCACC -> GCATTTGGCTTCCTTGATGCACCT
CTAACTGAGACGTTCTCAAAGGCA -> TAACTGAGACGTTCTCAAAGGCAC
GGAGTGTTTAAAGGAGAGAGGCAA -> GAGTGTTTAAAGGAGAGAGGCAAC
TGGGTGACCACGGACGTGTATGAC -> GGGTGACCACGGACGTGTATGACT
TATTCACCGACTAAGGATGTCAAA -> ATTCACCGACTAAGGATGTCAAAA
TAGGTACAAAACATCCTCCCTTTC -> AGGTACAAAACATCCTCCCTTTCC
ATTCACCGACTAAGGATGTCAAAA -> TTCACCGACTAAGGATGTCAAAAC
ACTAACTCGACCATCCGCCCAAAT -> CTAACTCGACCATCCGCCCAAATG
GCAATAATGTGCGTGGTGCTTCAA -> CAATAATGTGCGTGGTGCTTCAAA
ACAGTGAGGAACAATCGGGCGTCC -> CAGTGAGGAACAATCGGGCGTCCC
GGCTTATACCACGGCGTGCCCGCG -> GCTTATACCACGGCGTGCCCGCGA
AATATAGGATGTTGGCTCACGTAC -> ATATAGGATGTTGGCTCACGTACA
CTTATTGGGTGACCACGGACGTGT -> TTATTGGGTGACCACGGACGTGTA
GCCGTCGCCGATATCATCAAGTGG -> CCGTCGCCGATATCATCAAGTGGT
GCCCAGACTTAAAACCAAGGCAAG -> CCCAGACTTAAAACCAAGGCAAGG
CGACACATCAAGCCTACTAATGTA -> GACACATCAAGCCTACTAATGTAC
TGGGGTCATTGCCGAGGGCTAACT -> GGGGTCATTGCCGAGGGCTAACTT
CGGGCGGTTCGCCTCGCACAATTC -> GGGCGGTTCGCCTCGCACAATTCA
AGGAAGCCTCGAAATTTTAGGAAT -> GGAAGCCTCGAAATTTTAGGAATG
CGCGAATGATTTGCTATTGGCCAT -> GCGAATGATTTGCTATTGGCCATT
GTAATAACCTGTTCTACCCTAGCA -> TAATAACCTGTTCTACCCTAGCAT
ACTAGAACTATGACTGACTCGTCC -> CTAGAACTATGACTGACTCGTCCA
TGAGCCTTTAAGCAATTTACTTGC -> GAGCCTTTAAGCAATTTACTTGCT
AACTATGACTGACTCGTCCAAGGA -> ACTATGACTGACTCGTCCAAGGAA
AGGGCGAGTAACGGAACAAGCAGG -> GGGCGAGTAACGGAACAAGCAGGA
GCTATGCGTATAAGCGCGAATGAT -> CTATGCGTATAAGCGCGAATGATT
GCGGTTAGATACACATAGGGAGTT -> CGGTTAGATACACATAGGGAGTTA
GGTATCAGGCGCACAGTGAAAAGC -> GTATCAGGCGCACAGTGAAAAGCT
GTCTTAAGAAACCAGCGCATCGGC -> TCTTAAGAAACCAGCGCATCGGCA
ATGGAAATATAGGATGTTGGCTCA -> TGGAAATATAGGATGTTGGCTCAC
GACATGTGCGGGTGGCTAAGCTTC -> ACATGTGCGGGTGGCTAAGCTTCG
CATTCGCGCATTGAGTCTTCGAGC -> ATTCGCGCATTGAGTCTTCGAGCA
TAATGGGAGACGCCGGGATGGCCA -> AATGGGAGACGCCGGGATGGCCAG
TATATCACACTTATTGGGTGACCA -> ATATCACACTTATTGGGTGACCAC
GTGTCATACAAGTCTTGCGTGACA -> TGTCATACAAGTCTTGCGTGACAC
TCCGGACGACCACTTGAGTCGACA -> CCGGACGACCACTTGAGTCGACAC
CCACTGCGCCTTGTTGGAAACGGG -> CACTGCGCCTTGTTGGAAACGGGG
AGGAAAAATCAGTAATGATGGTTC -> GGAAAAATCAGTAATGATGGTTCA
GGCAATAATGTGCGTGGTGCTTCA -> GCAATAATGTGCGTGGTGCTTCAA
AGGACTCGGCCTTCACTCTGACAT -> GGACTCGGCCTTCACTCTGACATG
GTGGTGCTTCAAACGTCTTACTTC -> TGGTGCTTCAAACGTCTTACTTCG
GACGTTGTGAATTAGGCATCTCCG -> ACGTTGTGAATTAGGCATCTCCGG
GCCTCGCACAATTCACTCTGGTAC -> CCTCGCACAATTCACTCTGGTACC
CACAATTCACTCTGGTACCATTCG -> ACAATTCACTCTGGTACCATTCGC
TCCAGCCCGGCAATAATGTGCGTG -> CCAGCCCGGCAATAATGTGCGTGG
GAAAACGGAGAGGGGTTGGAACGT -> AAAACGGAGAGGGGTTGGAACGTT
CAGTGGCCCTAGCCCAATTGTTCG -> AGTGGCCCTAGCCCAATTGTTCGA
CTTTCCATAGTTCTGGAAGGAGTG -> TTTCCATAGTTCTGGAAGGAGTGT
TCTGGCGATTACACTATACCAGTG -> CTGGCGATTACACTATACCAGTGC
ACTGCCCAGACTTAAAACCAAGGC -> CTGCCCAGACTTAAAACCAAGGCA
GCGGACGTGTCTAGCCGTAGAAAT -> CGGACGTGTCTAGCCGTAGAAATA
GGAAACCGGCCGACGGGTAGGACT -> GAAACCGGCCGACGGGTAGGACTC
CGGCAGCTTCCCTAGACCCGCACA -> GGCAGCTTCCCTAGACCCGCACAA
GTGAATTAGGCATCTCCGGACGAC -> TGAATTAGGCATCTCCGGACGACC
TGGCGATTACACTATACCAGTGCA -> GGCGATTACACTATACCAGTGCAA
GACTTCACAAGGTAATAACCTGTT -> ACTTCACAAGGTAATAACCTGTTC
GCTATTGGCCATTAATCGCTTCCA -> CTATTGGCCATTAATCGCTTCCAA
CATGATTCGAGGGATGCTGGACGT -> ATGATTCGAGGGATGCTGGACGTA
CTCCTTTTATATGTGAAGTAGAGT -> TCCTTTTATATGTGAAGTAGAGTC
TAAAGACTTCACAAGGTAATAACC -> AAAGACTTCACAAGGTAATAACCT
CCTTTCCATAGTTCTGGAAGGAGT -> CTTTCCATAGTTCTGGAAGGAGTG
CCTCCCTTTCCATAGTTCTGGAAG -> CTCCCTTTCCATAGTTCTGGAAGG
TTCACTCTTTGCCAGACTTGGTAG -> TCACTCTTTGCCAGACTTGGTAGG
CATCCGCCCAAATGTAGAACGAAA -> ATCCGCCCAAATGTAGAACGAAAA
TAGGCATCTCCGGACGACCACTTG -> AGGCATCTCCGGACGACCACTTGA
CAGGTCTCACTAACTGAGACGTTC -> AGGTCTCACTAACTGAGACGTTCT
CGAATCCCTAGACTCGTGACTAGG -> GAATCCCTAGACTCGTGACTAGGT
AGTGTTTAAAGGAGAGAGGCAACA -> GTGTTTAAAGGAGAGAGGCAACAA
AAACGGAGAGGGGTTGGAACGTTC -> AACGGAGAGGGGTTGGAACGTTCC
GGCTTAAGTTAGGGTTAGATTAAT -> GCTTAAGTTAGGGTTAGATTAATG
ACTAGGGCGAGTAACGGAACAAGC -> CTAGGGCGAGTAACGGAACAAGCA
AATATATCACACTTATTGGGTGAC -> ATATATCACACTTATTGGGTGACC
TGCGCCTTGTTGGAAACGGGGAAA -> GCGCCTTGTTGGAAACGGGGAAAC
GTAAAGACTTCACAAGGTAATAAC -> TAAAGACTTCACAAGGTAATAACC
GCGCTGCATTAACGACGATATATC -> CGCTGCATTAACGACGATATATCG
AAGGAGTGTTTAAAGGAGAGAGGC -> AGGAGTGTTTAAAGGAGAGAGGCA
TGTTACAACGGATACCGCCTTGCA -> GTTACAACGGATACCGCCTTGCAT
GTTCACTCTTTGCCAGACTTGGTA -> TTCACTCTTTGCCAGACTTGGTAG
CAGTGCAATGAGCCTTTAAGCAAT -> AGTGCAATGAGCCTTTAAGCAATT
ATTCACGCAGCATCTCGAGCTATG -> TTCACGCAGCATCTCGAGCTATGC
TAGTGCGTGAGATTTCGTGCACGT -> AGTGCGTGAGATTTCGTGCACGTA
CCTGTGCTAGCGGCTTAAGTTAGG -> CTGTGCTAGCGGCTTAAGTTAGGG
GAAGGAGTGTTTAAAGGAGAGAGG -> AAGGAGTGTTTAAAGGAGAGAGGC
AAGCAATTTACTTGCTCCATCCCC -> AGCAATTTACTTGCTCCATCCCCA
CTTCGAGCACTGTTACAACGGATA -> TTCGAGCACTGTTACAACGGATAC
TTGGCGTATATCATAATACTGCGT -> TGGCGTATATCATAATACTGCGTT
AATGAGCCTTTAAGCAATTTACTT -> ATGAGCCTTTAAGCAATTTACTTG
CACAACTAGGGCGAGTAACGGAAC -> ACAACTAGGGCGAGTAACGGAACA
TCATTCATAGGTACAAAACATCCT -> CATTCATAGGTACAAAACATCCTC
CACTGAGTTGTAGGCGCTGCATTA -> ACTGAGTTGTAGGCGCTGCATTAA
AGCGCATCGGCAAGCAACGTTATA -> GCGCATCGGCAAGCAACGTTATAT
GAACAATCGGGCGTCCCCATTAGT -> AACAATCGGGCGTCCCCATTAGTG
TCGCGCATTGAGTCTTCGAGCACT -> CGCGCATTGAGTCTTCGAGCACTG
CACTCTGACATGTGCGGGTGGCTA -> ACTCTGACATGTGCGGGTGGCTAA
AATGTACGCAGGACGAAATCTATA -> ATGTACGCAGGACGAAATCTATAT
AGGCTCTCCAGCCCGGCAATAATG -> GGCTCTCCAGCCCGGCAATAATGT
AGCACCAACAATTTCCCCACTTTC -> GCACCAACAATTTCCCCACTTTCT
ACGTACAGTGAGGAACAATCGGGC -> CGTACAGTGAGGAACAATCGGGCG
CATAGTCCGGTGGGCACATCGCCA -> ATAGTCCGGTGGGCACATCGCCAT
GGGCTTATACCACGGCGTGCCCGC -> GGCTTATACCACGGCGTGCCCGCG
GTGAAGTAGAGTCTGGGATAGAGT -> TGAAGTAGAGTCTGGGATAGAGTA
GACCACGGACGTGTATGACTCTGT -> ACCACGGACGTGTATGACTCTGTT
GGAAAAATCAGTAATGATGGTTCA -> GAAAAATCAGTAATGATGGTTCAC
TCCTCCCTTTCCATAGTTCTGGAA -> CCTCCCTTTCCATAGTTCTGGAAG
GTGGGCACATCGCCATAGAAGTTG -> TGGGCACATCGCCATAGAAGTTGG
AGGCAGAAATAGAACCGAATCCCT -> GGCAGAAATAGAACCGAATCCCTA
CAACCTCGTAAACTGCCCAGACTT -> AACCTCGTAAACTGCCCAGACTTA
CTCGTCCAAGGAAAATCTGATTCG -> TCGTCCAAGGAAAATCTGATTCGC
AGGTAGGAAGCCTCGAAATTTTAG -> GGTAGGAAGCCTCGAAATTTTAGG
GGTATTGGGCTTATACCACGGCGT -> GTATTGGGCTTATACCACGGCGTG
TGACATGTGCGGGTGGCTAAGCTT -> GACATGTGCGGGTGGCTAAGCTTC
AAATTTTAGGAATGGTACCTTCAT -> AATTTTAGGAATGGTACCTTCATA
AACGTTTTTATGATCTCGCATCAT -> ACGTTTTTATGATCTCGCATCATT
GCGTTGCGAGTCGGCTGAGGTAGG -> CGTTGCGAGTCGGCTGAGGTAGGA
ACGTCATAGTCCGGTGGGCACATC -> CGTCATAGTCCGGTGGGCACATCG
GGACTCGGCCTTCACTCTGACATG -> GACTCGGCCTTCACTCTGACATGT
GACTAGGTATCAGAAATTCAGGCT -> ACTAGGTATCAGAAATTCAGGCTG
TCTTGCGTGACACCGCCTCCCTCG -> CTTGCGTGACACCGCCTCCCTCGA
CTGTTACAACGGATACCGCCTTGC -> TGTTACAACGGATACCGCCTTGCA
GTTCTACCCTAGCATTTGCGGTTA -> TTCTACCCTAGCATTTGCGGTTAG
GCGCGGTTTCTAACAGGTCTCACT -> CGCGGTTTCTAACAGGTCTCACTA
AGGCGCACAGTGAAAAGCTCCTTT -> GGCGCACAGTGAAAAGCTCCTTTT
GTACGCAGGACGAAATCTATATTA -> TACGCAGGACGAAATCTATATTAA
TTAACGACGATATATCGTGCCTCA -> TAACGACGATATATCGTGCCTCAC
TCTCCAGCCCGGCAATAATGTGCG -> CTCCAGCCCGGCAATAATGTGCGT
GACTACGGCAGCTTCCCTAGACCC -> ACTACGGCAGCTTCCCTAGACCCG
GATTAATGGGAGACGCCGGGATGG -> ATTAATGGGAGACGCCGGGATGGC
GACACATCAAGCCTACTAATGTAC -> ACACATCAAGCCTACTAATGTACG
AAGCATTTGGCTTCCTTGATGCAC -> AGCATTTGGCTTCCTTGATGCACC
TGATTCGAGGGATGCTGGACGTAG -> GATTCGAGGGATGCTGGACGTAGG
TCCGGTGGGCACATCGCCATAGAA -> CCGGTGGGCACATCGCCATAGAAG
GTAGGAAGCCTCGAAATTTTAGGA -> TAGGAAGCCTCGAAATTTTAGGAA
TCATAGGTACAAAACATCCTCCCT -> CATAGGTACAAAACATCCTCCCTT
GCATTAACGACGATATATCGTGCC -> CATTAACGACGATATATCGTGCCT
CGCGGTTTCTAACAGGTCTCACTA -> GCGGTTTCTAACAGGTCTCACTAA
ATCAGTAATGATGGTTCACTCTTT -> TCAGTAATGATGGTTCACTCTTTG
TAGCGTAAAGACTTCACAAGGTAA -> AGCGTAAAGACTTCACAAGGTAAT
GATGCACCTAAATAGTGCGTGAGA -> ATGCACCTAAATAGTGCGTGAGAT
CTATGCGTATAAGCGCGAATGATT -> TATGCGTATAAGCGCGAATGATTT
AGGGCCGTCGCCGATATCATCAAG -> GGGCCGTCGCCGATATCATCAAGT
ACGACCACTTGAGTCGACACATCA -> CGACCACTTGAGTCGACACATCAA
CAGTAATGATGGTTCACTCTTTGC -> AGTAATGATGGTTCACTCTTTGCC
AACTAGGGCGAGTAACGGAACAAG -> ACTAGGGCGAGTAACGGAACAAGC
TTATCTTGATAGGGCACAGCAGGA -> TATCTTGATAGGGCACAGCAGGAC
TCGTGTCGTGGCCAACCTCGTAAA -> CGTGTCGTGGCCAACCTCGTAAAC
TGCTGGACGTAGGGCGGACGTGTC -> GCTGGACGTAGGGCGGACGTGTCT
TTAGATTAATGGGAGACGCCGGGA -> TAGATTAATGGGAGACGCCGGGAT
GTCATTCATAGGTACAAAACATCC -> TCATTCATAGGTACAAAACATCCT
GCCGTTCTGCTGGTATTGGGCTTA -> CCGTTCTGCTGGTATTGGGCTTAT
GGGAGTTACGGACCTACAGACGGG -> GGAGTTACGGACCTACAGACGGGT
TCGTGCACGTACAGTGAGGAACAA -> CGTGCACGTACAGTGAGGAACAAT
TGGCCATTAATCGCTTCCAAAGGC -> GGCCATTAATCGCTTCCAAAGGCA
AAAACCAAGGCAAGGAAACAGGGA -> AAACCAAGGCAAGGAAACAGGGAC
AGTCTGGGATAGAGTATTCACCGA -> GTCTGGGATAGAGTATTCACCGAC
TGTTTGAGCGACGCATTGGTGTCT -> GTTTGAGCGACGCATTGGTGTCTG
GAAGCCTCGAAATTTTAGGAATGG -> AAGCCTCGAAATTTTAGGAATGGT
AAGCGCGAATGATTTGCTATTGGC -> AGCGCGAATGATTTGCTATTGGCC
ATCCTCCCTTTCCATAGTTCTGGA -> TCCTCCCTTTCCATAGTTCTGGAA
CGTACACTGAGTTGTAGGCGCTGC -> GTACACTGAGTTGTAGGCGCTGCA
GGGTCAGTATAACATGATTCGAGG -> GGTCAGTATAACATGATTCGAGGG
GACCCGAAGGGAGCACCAACAATT -> ACCCGAAGGGAGCACCAACAATTT
TATGCGTATAAGCGCGAATGATTT -> ATGCGTATAAGCGCGAATGATTTG
TCAGTATAACATGATTCGAGGGAT -> CAGTATAACATGATTCGAGGGATG
TTCAGGCTGCTTCCAGCAGCTACA -> TCAGGCTGCTTCCAGCAGCTACAT
CTACCCTAGCATTTGCGGTTAGAT -> TACCCTAGCATTTGCGGTTAGATA
CGACGCATTGGTGTCTGATGTTAA -> GACGCATTGGTGTCTGATGTTAAT
TGATCTCGCATCATTCCTGTGCTA -> GATCTCGCATCATTCCTGTGCTAG
ATTAGAACGTTGGTGAGTCATTCA -> TTAGAACGTTGGTGAGTCATTCAT
AGCCCGGCAATAATGTGCGTGGTG -> GCCCGGCAATAATGTGCGTGGTGC
TTCCAGCAGCTACATGACTACGGC -> TCCAGCAGCTACATGACTACGGCA
GGTATCAGAAATTCAGGCTGCTTC -> GTATCAGAAATTCAGGCTGCTTCC
GCGGGATGGGCACACCGCCTATGG -> CGGGATGGGCACACCGCCTATGGA
TGCGGGTGGCTAAGCTTCGAAAGT -> GCGGGTGGCTAAGCTTCGAAAGTT
GTGAAAAGCTCCTTTTATATGTGA -> TGAAAAGCTCCTTTTATATGTGAA
GGTACCTTCATACGATTTAATAGC -> GTACCTTCATACGATTTAATAGCG
CAGCTACATGACTACGGCAGCTTC -> AGCTACATGACTACGGCAGCTTCC
GCCCGCGAGAAGCAATAATTAGAA -> CCCGCGAGAAGCAATAATTAGAAC
GTCCGGTGGGCACATCGCCATAGA -> TCCGGTGGGCACATCGCCATAGAA
TTCCTGTGCTAGCGGCTTAAGTTA -> TCCTGTGCTAGCGGCTTAAGTTAG
CATCAAGTGGTGAAACGTTTTTAT -> ATCAAGTGGTGAAACGTTTTTATG
TATTAATAGTCCACTGCGCCTTGT -> ATTAATAGTCCACTGCGCCTTGTT
TGCCAGACTTGGTAGGCGTGTCAT -> GCCAGACTTGGTAGGCGTGTCATA
GATGGCCAGTGGCCCTAGCCCAAT -> ATGGCCAGTGGCCCTAGCCCAATT
TCTTACTTCGAAGTTCGCCGTTCT -> CTTACTTCGAAGTTCGCCGTTCTG
CCTATGGAAAGCATTTGGCTTCCT -> CTATGGAAAGCATTTGGCTTCCTT
CCGGACGACCACTTGAGTCGACAC -> CGGACGACCACTTGAGTCGACACA
GCCAGTGGCCCTAGCCCAATTGTT -> CCAGTGGCCCTAGCCCAATTGTTC
TAGGGTTAGATTAATGGGAGACGC -> AGGGTTAGATTAATGGGAGACGCC
GACGATATATCGTGCCTCACTAGA -> ACGATATATCGTGCCTCACTAGAA
GAATCCCTAGACTCGTGACTAGGT -> AATCCCTAGACTCGTGACTAGGTA
TCGTGAATATTTCCTCTGGCGATT -> CGTGAATATTTCCTCTGGCGATTA
GCGTGCCCGCGAGAAGCAATAATT -> CGTGCCCGCGAGAAGCAATAATTA
GCCAACCTCGTAAACTGCCCAGAC -> CCAACCTCGTAAACTGCCCAGACT
TGAGTCTTCGAGCACTGTTACAAC -> GAGTCTTCGAGCACTGTTACAACG
ATTGCATATCACTATGTTTGAGCG -> TTGCATATCACTATGTTTGAGCGA
CTAGGTATCAGAAATTCAGGCTGC -> TAGGTATCAGAAATTCAGGCTGCT
AGTTAGGGTTAGATTAATGGGAGA -> GTTAGGGTTAGATTAATGGGAGAC
CAATAATGTGCGTGGTGCTTCAAA -> AATAATGTGCGTGGTGCTTCAAAC
TTGAGTCGACACATCAAGCCTACT -> TGAGTCGACACATCAAGCCTACTA
TACACATAGGGAGTTACGGACCTA -> ACACATAGGGAGTTACGGACCTAC
TGCGTTGCGAGTCGGCTGAGGTAG -> GCGTTGCGAGTCGGCTGAGGTAGG
TGACACCGCCTCCCTCGACAACTA -> GACACCGCCTCCCTCGACAACTAA
TGAGCGACGCATTGGTGTCTGATG -> GAGCGACGCATTGGTGTCTGATGT
GGCGTATATCATAATACTGCGTTG -> GCGTATATCATAATACTGCGTTGC
GGAACAAGCAGGAAAAATCAGTAA -> GAACAAGCAGGAAAAATCAGTAAT
ATTTAATAGCGTAAAGACTTCACA -> TTTAATAGCGTAAAGACTTCACAA
AGAGGGGTTGGAACGTTCCTGGTC -> GAGGGGTTGGAACGTTCCTGGTCG
TCCCCATTAGTGTATGGAAATATA -> CCCCATTAGTGTATGGAAATATAG
ATACAAGTCTTGCGTGACACCGCC -> TACAAGTCTTGCGTGACACCGCCT
TCAAGTGGTGAAACGTTTTTATGA -> CAAGTGGTGAAACGTTTTTATGAT
AGATTAATGGGAGACGCCGGGATG -> GATTAATGGGAGACGCCGGGATGG
CAGAAATTCAGGCTGCTTCCAGCA -> AGAAATTCAGGCTGCTTCCAGCAG
TATCATAATACTGCGTTGCGAGTC -> ATCATAATACTGCGTTGCGAGTCG
CTGCATTAACGACGATATATCGTG -> TGCATTAACGACGATATATCGTGC
ACTTTCTTTTCATGGGGTCATTGC -> CTTTCTTTTCATGGGGTCATTGCC
TAACGACGATATATCGTGCCTCAC -> AACGACGATATATCGTGCCTCACT
GTGACCACGGACGTGTATGACTCT -> TGACCACGGACGTGTATGACTCTG
CCGACTAAGGATGTCAAAACGCCA -> CGACTAAGGATGTCAAAACGCCAA
ATGTTGGCTCACGTACACTGAGTT -> TGTTGGCTCACGTACACTGAGTTG
GCTAAGCTTCGAAAGTTGGCGTAT -> CTAAGCTTCGAAAGTTGGCGTATA
ACTCTGTTTGATTGCCGATTCACG -> CTCTGTTTGATTGCCGATTCACGC
TGCATTCGTGTCGTGGCCAACCTC -> GCATTCGTGTCGTGGCCAACCTCG
TTGCCGATTCACGCAGCATCTCGA -> TGCCGATTCACGCAGCATCTCGAG
TTTATGATCTCGCATCATTCCTGT -> TTATGATCTCGCATCATTCCTGTG
GGGATAGAGTATTCACCGACTAAG -> GGATAGAGTATTCACCGACTAAGG
GCCGTAGAAATAAATGATGGACGT -> CCGTAGAAATAAATGATGGACGTC
TCGCCGTTCTGCTGGTATTGGGCT -> CGCCGTTCTGCTGGTATTGGGCTT
AACAGGGACAGGGCCGTCGCCGAT -> ACAGGGACAGGGCCGTCGCCGATA
GTTTTGAATTGCATATCACTATGT -> TTTTGAATTGCATATCACTATGTT
AGCTACATGACTACGGCAGCTTCC -> GCTACATGACTACGGCAGCTTCCC
TGGAAGGAGTGTTTAAAGGAGAGA -> GGAAGGAGTGTTTAAAGGAGAGAG
CCACGGCGTGCCCGCGAGAAGCAA -> CACGGCGTGCCCGCGAGAAGCAAT
CCATTAATCGCTTCCAAAGGCAGA -> CATTAATCGCTTCCAAAGGCAGAA
CCATCCCCATCAAATATATCACAC -> CATCCCCATCAAATATATCACACT
TTGGGTATCAGGCGCACAGTGAAA -> TGGGTATCAGGCGCACAGTGAAAA
ATCTCGAGCTATGCGTATAAGCGC -> TCTCGAGCTATGCGTATAAGCGCG
TATCAGGCGCACAGTGAAAAGCTC -> ATCAGGCGCACAGTGAAAAGCTCC
GATGTCAAAACGCCAATGCAAAGA -> ATGTCAAAACGCCAATGCAAAGAC
ACATGACTACGGCAGCTTCCCTAG -> CATGACTACGGCAGCTTCCCTAGA
CGAGCACTGTTACAACGGATACCG -> GAGCACTGTTACAACGGATACCGC
GACGGGTCAGTATAACATGATTCG -> ACGGGTCAGTATAACATGATTCGA
TCGTCCAAGGAAAATCTGATTCGC -> CGTCCAAGGAAAATCTGATTCGCG
AGAACCGAATCCCTAGACTCGTGA -> GAACCGAATCCCTAGACTCGTGAC
TATAGGCTCTCCAGCCCGGCAATA -> ATAGGCTCTCCAGCCCGGCAATAA
ATAGTGCGTGAGATTTCGTGCACG -> TAGTGCGTGAGATTTCGTGCACGT
CGATATCATCAAGTGGTGAAACGT -> GATATCATCAAGTGGTGAAACGTT
TTCGCCTCGCACAATTCACTCTGG -> TCGCCTCGCACAATTCACTCTGGT
AGCGGCTTAAGTTAGGGTTAGATT -> GCGGCTTAAGTTAGGGTTAGATTA
GACGTCATAGTCCGGTGGGCACAT -> ACGTCATAGTCCGGTGGGCACATC
TTCATAGGTACAAAACATCCTCCC -> TCATAGGTACAAAACATCCTCCCT
GATGTTGGCTCACGTACACTGAGT -> ATGTTGGCTCACGTACACTGAGTT
GCCCGGCAATAATGTGCGTGGTGC -> CCCGGCAATAATGTGCGTGGTGCT
CGGACGACCACTTGAGTCGACACA -> GGACGACCACTTGAGTCGACACAT
GAAAAATCAGTAATGATGGTTCAC -> AAAAATCAGTAATGATGGTTCACT
CAGGAAAAATCAGTAATGATGGTT -> AGGAAAAATCAGTAATGATGGTTC
ATCAAGTGGTGAAACGTTTTTATG -> TCAAGTGGTGAAACGTTTTTATGA
CGTCGCCGATATCATCAAGTGGTG -> GTCGCCGATATCATCAAGTGGTGA
GCCCAATTGTTCGACATTATAGGC -> CCCAATTGTTCGACATTATAGGCT
GTTGCGAGTCGGCTGAGGTAGGAA -> TTGCGAGTCGGCTGAGGTAGGAAG
GACCCGCACAACTAGGGCGAGTAA -> ACCCGCACAACTAGGGCGAGTAAC
AATTTCCCCACTTTCTTTTCATGG -> ATTTCCCCACTTTCTTTTCATGGG
TCCTCTGGCGATTACACTATACCA -> CCTCTGGCGATTACACTATACCAG
TCTAGCCGTAGAAATAAATGATGG -> CTAGCCGTAGAAATAAATGATGGA
CCGGCCGACGGGTAGGACTCGGCC -> CGGCCGACGGGTAGGACTCGGCCT
ATACCGCCTTGCATTCGTGTCGTG -> TACCGCCTTGCATTCGTGTCGTGG
AGACTTGGTAGGCGTGTCATACAA -> GACTTGGTAGGCGTGTCATACAAG
GGCACATCGCCATAGAAGTTGGGT -> GCACATCGCCATAGAAGTTGGGTA
CTCACGTACACTGAGTTGTAGGCG -> TCACGTACACTGAGTTGTAGGCGC
GGAACGTTCCTGGTCGTAACGGGC -> GAACGTTCCTGGTCGTAACGGGCG
ACTTGTTTTGAATTGCATATCACT -> CTTGTTTTGAATTGCATATCACTA
GAGACGTTCTCAAAGGCACGTCGT -> AGACGTTCTCAAAGGCACGTCGTG
TCATACAAGTCTTGCGTGACACCG -> CATACAAGTCTTGCGTGACACCGC
TCACGTACACTGAGTTGTAGGCGC -> CACGTACACTGAGTTGTAGGCGCT
AGCCTTTAAGCAATTTACTTGCTC -> GCCTTTAAGCAATTTACTTGCTCC
TAACTTGTTTTGAATTGCATATCA -> AACTTGTTTTGAATTGCATATCAC
TCATAATACTGCGTTGCGAGTCGG -> CATAATACTGCGTTGCGAGTCGGC
GTATAACATGATTCGAGGGATGCT -> TATAACATGATTCGAGGGATGCTG
AGACTCGTGACTAGGTATCAGAAA -> GACTCGTGACTAGGTATCAGAAAT
GCAGCTACATGACTACGGCAGCTT -> CAGCTACATGACTACGGCAGCTTC
CGTGACTAGGTATCAGAAATTCAG -> GTGACTAGGTATCAGAAATTCAGG
CAGGGCCGTCGCCGATATCATCAA -> AGGGCCGTCGCCGATATCATCAAG
ATATTAATAGTCCACTGCGCCTTG -> TATTAATAGTCCACTGCGCCTTGT
TACCTTCATACGATTTAATAGCGT -> ACCTTCATACGATTTAATAGCGTA
CCGCCTTGCATTCGTGTCGTGGCC -> CGCCTTGCATTCGTGTCGTGGCCA
GTTTGATTGCCGATTCACGCAGCA -> TTTGATTGCCGATTCACGCAGCAT
ACGCATTGGTGTCTGATGTTAATG -> CGCATTGGTGTCTGATGTTAATGA
GACGTTCTCAAAGGCACGTCGTGA -> ACGTTCTCAAAGGCACGTCGTGAA
AATAAATGATGGACGTCATAGTCC -> ATAAATGATGGACGTCATAGTCCG
AAATTCTCAGACGTTGTGAATTAG -> AATTCTCAGACGTTGTGAATTAGG
CTGATTCGCGCGGTTTCTAACAGG -> TGATTCGCGCGGTTTCTAACAGGT
AATAGAACCGAATCCCTAGACTCG -> ATAGAACCGAATCCCTAGACTCGT
TGGGTATCAGGCGCACAGTGAAAA -> GGGTATCAGGCGCACAGTGAAAAG
GGGATGCTGGACGTAGGGCGGACG -> GGATGCTGGACGTAGGGCGGACGT
TAGAGTATTCACCGACTAAGGATG -> AGAGTATTCACCGACTAAGGATGT
AACAATCGGGCGTCCCCATTAGTG -> ACAATCGGGCGTCCCCATTAGTGT
GCCGATTCACGCAGCATCTCGAGC -> CCGATTCACGCAGCATCTCGAGCT
AGTAGAGTCTGGGATAGAGTATTC -> GTAGAGTCTGGGATAGAGTATTCA
TGGTGAGTCATTCATAGGTACAAA -> GGTGAGTCATTCATAGGTACAAAA
ACGGCAGCTTCCCTAGACCCGCAC -> CGGCAGCTTCCCTAGACCCGCACA
ACTATACCAGTGCAATGAGCCTTT -> CTATACCAGTGCAATGAGCCTTTA
CGACGATATATCGTGCCTCACTAG -> GACGATATATCGTGCCTCACTAGA
ATCCCCATCAAATATATCACACTT -> TCCCCATCAAATATATCACACTTA
GGCTAACTTGTTTTGAATTGCATA -> GCTAACTTGTTTTGAATTGCATAT
ATACGATTTAATAGCGTAAAGACT -> TACGATTTAATAGCGTAAAGACTT
GGAAACGGGGAAACCGGCCGACGG -> GAAACGGGGAAACCGGCCGACGGG
ATAATACTGCGTTGCGAGTCGGCT -> TAATACTGCGTTGCGAGTCGGCTG
GCAAGCAACGTTATATTATCTTGA -> CAAGCAACGTTATATTATCTTGAT
AATTAGGCATCTCCGGACGACCAC -> ATTAGGCATCTCCGGACGACCACT
AAGTTCGCCGTTCTGCTGGTATTG -> AGTTCGCCGTTCTGCTGGTATTGG
TTTCATGGGGTCATTGCCGAGGGC -> TTCATGGGGTCATTGCCGAGGGCT
GTCGTAACGGGCGGTTCGCCTCGC -> TCGTAACGGGCGGTTCGCCTCGCA
CTCCCTTTCCATAGTTCTGGAAGG -> TCCCTTTCCATAGTTCTGGAAGGA
GTAACGGAACAAGCAGGAAAAATC -> TAACGGAACAAGCAGGAAAAATCA
TCCGCCCAAATGTAGAACGAAAAC -> CCGCCCAAATGTAGAACGAAAACG
CCTACAGACGGGTCAGTATAACAT -> CTACAGACGGGTCAGTATAACATG
ACATGTGCGGGTGGCTAAGCTTCG -> CATGTGCGGGTGGCTAAGCTTCGA
TTGATTGCCGATTCACGCAGCATC -> TGATTGCCGATTCACGCAGCATCT
AAAGTTGGCGTATATCATAATACT -> AAGTTGGCGTATATCATAATACTG
GACGGGTAGGACTCGGCCTTCACT -> ACGGGTAGGACTCGGCCTTCACTC
GGGGAAACCGGCCGACGGGTAGGA -> GGGAAACCGGCCGACGGGTAGGAC
TGCTATTGGCCATTAATCGCTTCC -> GCTATTGGCCATTAATCGCTTCCA
ACAATCGGGCGTCCCCATTAGTGT -> CAATCGGGCGTCCCCATTAGTGTA
CTAGCGGCTTAAGTTAGGGTTAGA -> TAGCGGCTTAAGTTAGGGTTAGAT
GATTCGCGCGGTTTCTAACAGGTC -> ATTCGCGCGGTTTCTAACAGGTCT
TTGGTGTCTGATGTTAATGAGTGA -> TGGTGTCTGATGTTAATGAGTGAA
CACTCTTTGCCAGACTTGGTAGGC -> ACTCTTTGCCAGACTTGGTAGGCG
GAAACCGGCCGACGGGTAGGACTC -> AAACCGGCCGACGGGTAGGACTCG
TGAAGTAGAGTCTGGGATAGAGTA -> GAAGTAGAGTCTGGGATAGAGTAT
AACGTTCCTGGTCGTAACGGGCGG -> ACGTTCCTGGTCGTAACGGGCGGT
ACCGCCTCCCTCGACAACTAACTC -> CCGCCTCCCTCGACAACTAACTCG
AAACCAGCGCATCGGCAAGCAACG -> AACCAGCGCATCGGCAAGCAACGT
GACGTGTATGACTCTGTTTGATTG -> ACGTGTATGACTCTGTTTGATTGC
AAGGATGTCAAAACGCCAATGCAA -> AGGATGTCAAAACGCCAATGCAAA
GGTACAAAACATCCTCCCTTTCCA -> GTACAAAACATCCTCCCTTTCCAT
ATCTCCGGACGACCACTTGAGTCG -> TCTCCGGACGACCACTTGAGTCGA
CTGCGTTGCGAGTCGGCTGAGGTA -> TGCGTTGCGAGTCGGCTGAGGTAG
CTCAAAGGCACGTCGTGAATATTT -> TCAAAGGCACGTCGTGAATATTTC
ATGGAAAGCATTTGGCTTCCTTGA -> TGGAAAGCATTTGGCTTCCTTGAT
ACTGCGTTGCGAGTCGGCTGAGGT -> CTGCGTTGCGAGTCGGCTGAGGTA
AGTGAAAAGCTCCTTTTATATGTG -> GTGAAAAGCTCCTTTTATATGTGA
AAGCAACGTTATATTATCTTGATA -> AGCAACGTTATATTATCTTGATAG
TCCCTAGACCCGCACAACTAGGGC -> CCCTAGACCCGCACAACTAGGGCG
TTCTTTTCATGGGGTCATTGCCGA -> TCTTTTCATGGGGTCATTGCCGAG
AATAACCTGTTCTACCCTAGCATT -> ATAACCTGTTCTACCCTAGCATTT
GCCATTAATCGCTTCCAAAGGCAG -> CCATTAATCGCTTCCAAAGGCAGA
GCGTCCCCATTAGTGTATGGAAAT -> CGTCCCCATTAGTGTATGGAAATA
CGTCTTACTTCGAAGTTCGCCGTT -> GTCTTACTTCGAAGTTCGCCGTTC
CACCTAAATAGTGCGTGAGATTTC -> ACCTAAATAGTGCGTGAGATTTCG
CCGTCGCCGATATCATCAAGTGGT -> CGTCGCCGATATCATCAAGTGGTG
TGTTTAAAGGAGAGAGGCAACAAC -> GTTTAAAGGAGAGAGGCAACAACC
GAGTCGACACATCAAGCCTACTAA -> AGTCGACACATCAAGCCTACTAAT
GCCTTCACTCTGACATGTGCGGGT -> CCTTCACTCTGACATGTGCGGGTG
GGGATGGGCACACCGCCTATGGAA -> GGATGGGCACACCGCCTATGGAAA
TATGTGAAGTAGAGTCTGGGATAG -> ATGTGAAGTAGAGTCTGGGATAGA
AAAGCTCCTTTTATATGTGAAGTA -> AAGCTCCTTTTATATGTGAAGTAG
TACATGACTACGGCAGCTTCCCTA -> ACATGACTACGGCAGCTTCCCTAG
AATTTTAGGAATGGTACCTTCATA -> ATTTTAGGAATGGTACCTTCATAC
TTCATACGATTTAATAGCGTAAAG -> TCATACGATTTAATAGCGTAAAGA
CGTTTTTATGATCTCGCATCATTC -> GTTTTTATGATCTCGCATCATTCC
GGCGTGTCATACAAGTCTTGCGTG -> GCGTGTCATACAAGTCTTGCGTGA
CCTAGCCCAATTGTTCGACATTAT -> CTAGCCCAATTGTTCGACATTATA
CACAGCAGGACCCGAAGGGAGCAC -> ACAGCAGGACCCGAAGGGAGCACC
TTTTGAATTGCATATCACTATGTT -> TTTGAATTGCATATCACTATGTTT
GTTCGCCTCGCACAATTCACTCTG -> TTCGCCTCGCACAATTCACTCTGG
ACTGAGACGTTCTCAAAGGCACGT -> CTGAGACGTTCTCAAAGGCACGTC
CCCATTAGTGTATGGAAATATAGG -> CCATTAGTGTATGGAAATATAGGA
GTTGGAAACGGGGAAACCGGCCGA -> TTGGAAACGGGGAAACCGGCCGAC
GGTTTCTAACAGGTCTCACTAACT -> GTTTCTAACAGGTCTCACTAACTG
GGGGTTGGAACGTTCCTGGTCGTA -> GGGTTGGAACGTTCCTGGTCGTAA
TAAACTGCCCAGACTTAAAACCAA -> AAACTGCCCAGACTTAAAACCAAG
AATTTACTTGCTCCATCCCCATCA -> ATTTACTTGCTCCATCCCCATCAA
TGAGTGAAATTCTCAGACGTTGTG -> GAGTGAAATTCTCAGACGTTGTGA
GGACGTAGGGCGGACGTGTCTAGC -> GACGTAGGGCGGACGTGTCTAGCC
TAAGGATGTCAAAACGCCAATGCA -> AAGGATGTCAAAACGCCAATGCAA
CATACGATTTAATAGCGTAAAGAC -> ATACGATTTAATAGCGTAAAGACT
TGATGGACGTCATAGTCCGGTGGG -> GATGGACGTCATAGTCCGGTGGGC
TAACGGGCGGTTCGCCTCGCACAA -> AACGGGCGGTTCGCCTCGCACAAT
TAGGGCGGACGTGTCTAGCCGTAG -> AGGGCGGACGTGTCTAGCCGTAGA
CAGGACGAAATCTATATTAATAGT -> AGGACGAAATCTATATTAATAGTC
GTGAGATTTCGTGCACGTACAGTG -> TGAGATTTCGTGCACGTACAGTGA
CGCCTTGTTGGAAACGGGGAAACC -> GCCTTGTTGGAAACGGGGAAACCG
AGTGCGTGAGATTTCGTGCACGTA -> GTGCGTGAGATTTCGTGCACGTAC
AATCTATATTAATAGTCCACTGCG -> ATCTATATTAATAGTCCACTGCGC
GCGGGTGGCTAAGCTTCGAAAGTT -> CGGGTGGCTAAGCTTCGAAAGTTG
CTAGACCCGCACAACTAGGGCGAG -> TAGACCCGCACAACTAGGGCGAGT
AATAGTCCACTGCGCCTTGTTGGA -> ATAGTCCACTGCGCCTTGTTGGAA
TGAGGTAGGAAGCCTCGAAATTTT -> GAGGTAGGAAGCCTCGAAATTTTA
CGCCTTGCATTCGTGTCGTGGCCA -> GCCTTGCATTCGTGTCGTGGCCAA
AGCCTCGAAATTTTAGGAATGGTA -> GCCTCGAAATTTTAGGAATGGTAC
CATCTCGAGCTATGCGTATAAGCG -> ATCTCGAGCTATGCGTATAAGCGC
CATTCATAGGTACAAAACATCCTC -> ATTCATAGGTACAAAACATCCTCC
GCCGACGGGTAGGACTCGGCCTTC -> CCGACGGGTAGGACTCGGCCTTCA
GGCAAGGAAACAGGGACAGGGCCG -> GCAAGGAAACAGGGACAGGGCCGT
GGAACAATCGGGCGTCCCCATTAG -> GAACAATCGGGCGTCCCCATTAGT
TTAAGCAATTTACTTGCTCCATCC -> TAAGCAATTTACTTGCTCCATCCC
GTTGGCTCACGTACACTGAGTTGT -> TTGGCTCACGTACACTGAGTTGTA
CGTAAAGACTTCACAAGGTAATAA -> GTAAAGACTTCACAAGGTAATAAC
CGCCATAGAAGTTGGGTATCAGGC -> GCCATAGAAGTTGGGTATCAGGCG
CTCTGGTACCATTCGCGCATTGAG -> TCTGGTACCATTCGCGCATTGAGT
CTGTTCTACCCTAGCATTTGCGGT -> TGTTCTACCCTAGCATTTGCGGTT
ATTGGGCTTATACCACGGCGTGCC -> TTGGGCTTATACCACGGCGTGCCC
GTATAAGCGCGAATGATTTGCTAT -> TATAAGCGCGAATGATTTGCTATT
CAGTGAAAAGCTCCTTTTATATGT -> AGTGAAAAGCTCCTTTTATATGTG
CTCCCTCGACAACTAACTCGACCA -> TCCCTCGACAACTAACTCGACCAT
TAGCATTTGCGGTTAGATACACAT -> AGCATTTGCGGTTAGATACACATA
GATACCGCCTTGCATTCGTGTCGT -> ATACCGCCTTGCATTCGTGTCGTG
CCAATTGTTCGACATTATAGGCTC -> CAATTGTTCGACATTATAGGCTCT
TTTAAGCAATTTACTTGCTCCATC -> TTAAGCAATTTACTTGCTCCATCC
CCGCGAGAAGCAATAATTAGAACG -> CGCGAGAAGCAATAATTAGAACGT
GTAGAACGAAAACGGAGAGGGGTT -> TAGAACGAAAACGGAGAGGGGTTG
GCGTGTCATACAAGTCTTGCGTGA -> CGTGTCATACAAGTCTTGCGTGAC
TGTGCGGGTGGCTAAGCTTCGAAA -> GTGCGGGTGGCTAAGCTTCGAAAG
CCTTGATGCACCTAAATAGTGCGT -> CTTGATGCACCTAAATAGTGCGTG
AGGAGAGAGGCAACAACCGCTCGT -> GGAGAGAGGCAACAACCGCTCGTC
TTAGGAATGGTACCTTCATACGAT -> TAGGAATGGTACCTTCATACGATT
GCCGGGATGGCCAGTGGCCCTAGC -> CCGGGATGGCCAGTGGCCCTAGCC
CACTTATTGGGTGACCACGGACGT -> ACTTATTGGGTGACCACGGACGTG
GGCCCTAGCCCAATTGTTCGACAT -> GCCCTAGCCCAATTGTTCGACATT
ACACTGAGTTGTAGGCGCTGCATT -> CACTGAGTTGTAGGCGCTGCATTA
GGGCGTCCCCATTAGTGTATGGAA -> GGCGTCCCCATTAGTGTATGGAAA
AACTAACTCGACCATCCGCCCAAA -> ACTAACTCGACCATCCGCCCAAAT
TTGCTATTGGCCATTAATCGCTTC -> TGCTATTGGCCATTAATCGCTTCC
ACAGGGACAGGGCCGTCGCCGATA -> CAGGGACAGGGCCGTCGCCGATAT
CTTGGTAGGCGTGTCATACAAGTC -> TTGGTAGGCGTGTCATACAAGTCT
ATTAACGACGATATATCGTGCCTC -> TTAACGACGATATATCGTGCCTCA
TCTTAAGAAACCAGCGCATCGGCA -> CTTAAGAAACCAGCGCATCGGCAA
GGAAATATAGGATGTTGGCTCACG -> GAAATATAGGATGTTGGCTCACGT
GGCGATTACACTATACCAGTGCAA -> GCGATTACACTATACCAGTGCAAT
ATAACATGATTCGAGGGATGCTGG -> TAACATGATTCGAGGGATGCTGGA
AGGACGAAATCTATATTAATAGTC -> GGACGAAATCTATATTAATAGTCC
ATTGTTCGACATTATAGGCTCTCC -> TTGTTCGACATTATAGGCTCTCCA
ACACATAGGGAGTTACGGACCTAC -> CACATAGGGAGTTACGGACCTACA
GAAATAAATGATGGACGTCATAGT -> AAATAAATGATGGACGTCATAGTC
CGCCTCGCACAATTCACTCTGGTA -> GCCTCGCACAATTCACTCTGGTAC
ATTCGAGGGATGCTGGACGTAGGG -> TTCGAGGGATGCTGGACGTAGGGC
CAGGCGCACAGTGAAAAGCTCCTT -> AGGCGCACAGTGAAAAGCTCCTTT
GACTCGTGACTAGGTATCAGAAAT -> ACTCGTGACTAGGTATCAGAAATT
GAGCCTTTAAGCAATTTACTTGCT -> AGCCTTTAAGCAATTTACTTGCTC
ACGGACGTGTATGACTCTGTTTGA -> CGGACGTGTATGACTCTGTTTGAT
GAGCGACGCATTGGTGTCTGATGT -> AGCGACGCATTGGTGTCTGATGTT
ATGCGTATAAGCGCGAATGATTTG -> TGCGTATAAGCGCGAATGATTTGC
TTAAAACCAAGGCAAGGAAACAGG -> TAAAACCAAGGCAAGGAAACAGGG
GAACTATGACTGACTCGTCCAAGG -> AACTATGACTGACTCGTCCAAGGA
GCGTGAGATTTCGTGCACGTACAG -> CGTGAGATTTCGTGCACGTACAGT
ACCGCCTATGGAAAGCATTTGGCT -> CCGCCTATGGAAAGCATTTGGCTT
AAGGTAATAACCTGTTCTACCCTA -> AGGTAATAACCTGTTCTACCCTAG
TTGAATTGCATATCACTATGTTTG -> TGAATTGCATATCACTATGTTTGA
GCACAGTGAAAAGCTCCTTTTATA -> CACAGTGAAAAGCTCCTTTTATAT
AATGATGGTTCACTCTTTGCCAGA -> ATGATGGTTCACTCTTTGCCAGAC
GCACCAACAATTTCCCCACTTTCT -> CACCAACAATTTCCCCACTTTCTT
GAAAATCTGATTCGCGCGGTTTCT -> AAAATCTGATTCGCGCGGTTTCTA
AGTAACGGAACAAGCAGGAAAAAT -> GTAACGGAACAAGCAGGAAAAATC
ACACTTATTGGGTGACCACGGACG -> CACTTATTGGGTGACCACGGACGT
GAACCGAATCCCTAGACTCGTGAC -> AACCGAATCCCTAGACTCGTGACT
AAAGACTTCACAAGGTAATAACCT -> AAGACTTCACAAGGTAATAACCTG
TTGCGGTTAGATACACATAGGGAG -> TGCGGTTAGATACACATAGGGAGT
GAGCTATGCGTATAAGCGCGAATG -> AGCTATGCGTATAAGCGCGAATGA
GGCCGTCGCCGATATCATCAAGTG -> GCCGTCGCCGATATCATCAAGTGG
TGGCTCACGTACACTGAGTTGTAG -> GGCTCACGTACACTGAGTTGTAGG
CGCTGCATTAACGACGATATATCG -> GCTGCATTAACGACGATATATCGT
TTCACCGACTAAGGATGTCAAAAC -> TCACCGACTAAGGATGTCAAAACG
ATGGGGTCATTGCCGAGGGCTAAC -> TGGGGTCATTGCCGAGGGCTAACT
TTAGAACGTTGGTGAGTCATTCAT -> TAGAACGTTGGTGAGTCATTCATA
ATTTGCGGTTAGATACACATAGGG -> TTTGCGGTTAGATACACATAGGGA
AGGAAACAGGGACAGGGCCGTCGC -> GGAAACAGGGACAGGGCCGTCGCC
CACAGTGAAAAGCTCCTTTTATAT -> ACAGTGAAAAGCTCCTTTTATATG
ACTATGACTGACTCGTCCAAGGAA -> CTATGACTGACTCGTCCAAGGAAA
TGATTGCCGATTCACGCAGCATCT -> GATTGCCGATTCACGCAGCATCTC
AAGGCAAGGAAACAGGGACAGGGC -> AGGCAAGGAAACAGGGACAGGGCC
ATGGGCACACCGCCTATGGAAAGC -> TGGGCACACCGCCTATGGAAAGCA
CGCCTCCCTCGACAACTAACTCGA -> GCCTCCCTCGACAACTAACTCGAC
TGTCAAAACGCCAATGCAAAGACT -> GTCAAAACGCCAATGCAAAGACTG
CCGCCTATGGAAAGCATTTGGCTT -> CGCCTATGGAAAGCATTTGGCTTC
AATGAGTGAAATTCTCAGACGTTG -> ATGAGTGAAATTCTCAGACGTTGT
AATATTTCCTCTGGCGATTACACT -> ATATTTCCTCTGGCGATTACACTA
AAAGGCACGTCGTGAATATTTCCT -> AAGGCACGTCGTGAATATTTCCTC
AGATACACATAGGGAGTTACGGAC -> GATACACATAGGGAGTTACGGACC
GCTACATGACTACGGCAGCTTCCC -> CTACATGACTACGGCAGCTTCCCT
CAATTGTTCGACATTATAGGCTCT -> AATTGTTCGACATTATAGGCTCTC
ATCTCGCATCATTCCTGTGCTAGC -> TCTCGCATCATTCCTGTGCTAGCG
TCGGCCTTCACTCTGACATGTGCG -> CGGCCTTCACTCTGACATGTGCGG
ACAACGGATACCGCCTTGCATTCG -> CAACGGATACCGCCTTGCATTCGT
AGGTAATAACCTGTTCTACCCTAG -> GGTAATAACCTGTTCTACCCTAGC
CGTTCTGCTGGTATTGGGCTTATA -> GTTCTGCTGGTATTGGGCTTATAC
TAATGTGCGTGGTGCTTCAAACGT -> AATGTGCGTGGTGCTTCAAACGTC
CGCACAGTGAAAAGCTCCTTTTAT -> GCACAGTGAAAAGCTCCTTTTATA
TAATGTACGCAGGACGAAATCTAT -> AATGTACGCAGGACGAAATCTATA
GGGCGGACGTGTCTAGCCGTAGAA -> GGCGGACGTGTCTAGCCGTAGAAA
TATTTCCTCTGGCGATTACACTAT -> ATTTCCTCTGGCGATTACACTATA
GAGTCATTCATAGGTACAAAACAT -> AGTCATTCATAGGTACAAAACATC
TGTTAATGAGTGAAATTCTCAGAC -> GTTAATGAGTGAAATTCTCAGACG
TGTATGACTCTGTTTGATTGCCGA -> GTATGACTCTGTTTGATTGCCGAT
TTACGGACCTACAGACGGGTCAGT -> TACGGACCTACAGACGGGTCAGTA
TTAATGAGTGAAATTCTCAGACGT -> TAATGAGTGAAATTCTCAGACGTT
CTGGTCGTAACGGGCGGTTCGCCT -> TGGTCGTAACGGGCGGTTCGCCTC
TGAATATTTCCTCTGGCGATTACA -> GAATATTTCCTCTGGCGATTACAC
GTTCGACATTATAGGCTCTCCAGC -> TTCGACATTATAGGCTCTCCAGCC
AGAGTCTGGGATAGAGTATTCACC -> GAGTCTGGGATAGAGTATTCACCG
AGTTCTGGAAGGAGTGTTTAAAGG -> GTTCTGGAAGGAGTGTTTAAAGGA
TTTGAGCGACGCATTGGTGTCTGA -> TTGAGCGACGCATTGGTGTCTGAT
CAAGGCAAGGAAACAGGGACAGGG -> AAGGCAAGGAAACAGGGACAGGGC
TCACTATGTTTGAGCGACGCATTG -> CACTATGTTTGAGCGACGCATTGG
CATCGGCAAGCAACGTTATATTAT -> ATCGGCAAGCAACGTTATATTATC
GACGCATTGGTGTCTGATGTTAAT -> ACGCATTGGTGTCTGATGTTAATG
TTCCCTAGACCCGCACAACTAGGG -> TCCCTAGACCCGCACAACTAGGGC
GTTATATTATCTTGATAGGGCACA -> TTATATTATCTTGATAGGGCACAG
ACTCTGACATGTGCGGGTGGCTAA -> CTCTGACATGTGCGGGTGGCTAAG
TACAGACGGGTCAGTATAACATGA -> ACAGACGGGTCAGTATAACATGAT
GTTACGGACCTACAGACGGGTCAG -> TTACGGACCTACAGACGGGTCAGT
AGATTTCGTGCACGTACAGTGAGG -> GATTTCGTGCACGTACAGTGAGGA
AGCAACGTTATATTATCTTGATAG -> GCAACGTTATATTATCTTGATAGG
GCCTCCCTCGACAACTAACTCGAC -> CCTCCCTCGACAACTAACTCGACC
GGGCTAACTTGTTTTGAATTGCAT -> GGCTAACTTGTTTTGAATTGCATA
GCACGTACAGTGAGGAACAATCGG -> CACGTACAGTGAGGAACAATCGGG
CGCCCAAATGTAGAACGAAAACGG -> GCCCAAATGTAGAACGAAAACGGA
AGCGACGCATTGGTGTCTGATGTT -> GCGACGCATTGGTGTCTGATGTTA
CTATGGAAAGCATTTGGCTTCCTT -> TATGGAAAGCATTTGGCTTCCTTG
TTGCGTGACACCGCCTCCCTCGAC -> TGCGTGACACCGCCTCCCTCGACA
GCAGAAATAGAACCGAATCCCTAG -> CAGAAATAGAACCGAATCCCTAGA
AGTCTTCGAGCACTGTTACAACGG -> GTCTTCGAGCACTGTTACAACGGA
CTGCCCAGACTTAAAACCAAGGCA -> TGCCCAGACTTAAAACCAAGGCAA
CCATAGTTCTGGAAGGAGTGTTTA -> CATAGTTCTGGAAGGAGTGTTTAA
GGACGAAATCTATATTAATAGTCC -> GACGAAATCTATATTAATAGTCCA
GAAGGGAGCACCAACAATTTCCCC -> AAGGGAGCACCAACAATTTCCCCA
TTCGTGTCGTGGCCAACCTCGTAA -> TCGTGTCGTGGCCAACCTCGTAAA
AGGGTTAGATTAATGGGAGACGCC -> GGGTTAGATTAATGGGAGACGCCG
CTTACTTCGAAGTTCGCCGTTCTG -> TTACTTCGAAGTTCGCCGTTCTGC
CTCGTAAACTGCCCAGACTTAAAA -> TCGTAAACTGCCCAGACTTAAAAC
ATATCACACTTATTGGGTGACCAC -> TATCACACTTATTGGGTGACCACG
TGCCGATTCACGCAGCATCTCGAG -> GCCGATTCACGCAGCATCTCGAGC
ATTTACTTGCTCCATCCCCATCAA -> TTTACTTGCTCCATCCCCATCAAA
CACTTGAGTCGACACATCAAGCCT -> ACTTGAGTCGACACATCAAGCCTA
AGTGGCCCTAGCCCAATTGTTCGA -> GTGGCCCTAGCCCAATTGTTCGAC
ATGCGGGATGGGCACACCGCCTAT -> TGCGGGATGGGCACACCGCCTATG
TCCATAGTTCTGGAAGGAGTGTTT -> CCATAGTTCTGGAAGGAGTGTTTA
GCAGCATCTCGAGCTATGCGTATA -> CAGCATCTCGAGCTATGCGTATAA
ATTCATAGGTACAAAACATCCTCC -> TTCATAGGTACAAAACATCCTCCC
GTCGCCGATATCATCAAGTGGTGA -> TCGCCGATATCATCAAGTGGTGAA
GAGTCGGCTGAGGTAGGAAGCCTC -> AGTCGGCTGAGGTAGGAAGCCTCG
TGCCTCACTAGAACTATGACTGAC -> GCCTCACTAGAACTATGACTGACT
CAGACTTAAAACCAAGGCAAGGAA -> AGACTTAAAACCAAGGCAAGGAAA
CAGCATCTCGAGCTATGCGTATAA -> AGCATCTCGAGCTATGCGTATAAG
TAAGCAATTTACTTGCTCCATCCC -> AAGCAATTTACTTGCTCCATCCCC
GTGAAACGTTTTTATGATCTCGCA -> TGAAACGTTTTTATGATCTCGCAT
CCCAATTGTTCGACATTATAGGCT -> CCAATTGTTCGACATTATAGGCTC
TTTCTAACAGGTCTCACTAACTGA -> TTCTAACAGGTCTCACTAACTGAG
TAACCTGTTCTACCCTAGCATTTG -> AACCTGTTCTACCCTAGCATTTGC
CATAATACTGCGTTGCGAGTCGGC -> ATAATACTGCGTTGCGAGTCGGCT
GAAATAGAACCGAATCCCTAGACT -> AAATAGAACCGAATCCCTAGACTC
TTCAAACGTCTTACTTCGAAGTTC -> TCAAACGTCTTACTTCGAAGTTCG
CGAGGGATGCTGGACGTAGGGCGG -> GAGGGATGCTGGACGTAGGGCGGA
CTTGATGCACCTAAATAGTGCGTG -> TTGATGCACCTAAATAGTGCGTGA
GAGAGAGGCAACAACCGCTCGTCT -> AGAGAGGCAACAACCGCTCGTCTT
TCTGGGATAGAGTATTCACCGACT -> CTGGGATAGAGTATTCACCGACTA
CGCGCGGTTTCTAACAGGTCTCAC -> GCGCGGTTTCTAACAGGTCTCACT
TCTTCGAGCACTGTTACAACGGAT -> CTTCGAGCACTGTTACAACGGATA
CTACAGACGGGTCAGTATAACATG -> TACAGACGGGTCAGTATAACATGA
CCCTAGCATTTGCGGTTAGATACA -> CCTAGCATTTGCGGTTAGATACAC
TCGAAAGTTGGCGTATATCATAAT -> CGAAAGTTGGCGTATATCATAATA
AACCGAATCCCTAGACTCGTGACT -> ACCGAATCCCTAGACTCGTGACTA
GAAATTTTAGGAATGGTACCTTCA -> AAATTTTAGGAATGGTACCTTCAT
CTATATTAATAGTCCACTGCGCCT -> TATATTAATAGTCCACTGCGCCTT
TCTTGATAGGGCACAGCAGGACCC -> CTTGATAGGGCACAGCAGGACCCG
TGAATTAGGCATCTCCGGACGACC -> GAATTAGGCATCTCCGGACGACCA
CTCGACCATCCGCCCAAATGTAGA -> TCGACCATCCGCCCAAATGTAGAA
CAGCCCGGCAATAATGTGCGTGGT -> AGCCCGGCAATAATGTGCGTGGTG
CACTAGAACTATGACTGACTCGTC -> ACTAGAACTATGACTGACTCGTCC
ATTCACTCTGGTACCATTCGCGCA -> TTCACTCTGGTACCATTCGCGCAT
TCCAAGGAAAATCTGATTCGCGCG -> CCAAGGAAAATCTGATTCGCGCGG
GAATGGTACCTTCATACGATTTAA -> AATGGTACCTTCATACGATTTAAT
CCCACTTTCTTTTCATGGGGTCAT -> CCACTTTCTTTTCATGGGGTCATT
CTCTGTTTGATTGCCGATTCACGC -> TCTGTTTGATTGCCGATTCACGCA
GATGGTTCACTCTTTGCCAGACTT -> ATGGTTCACTCTTTGCCAGACTTG
TGAAACGTTTTTATGATCTCGCAT -> GAAACGTTTTTATGATCTCGCATC
GCAACGTTATATTATCTTGATAGG -> CAACGTTATATTATCTTGATAGGG
CATCCCCATCAAATATATCACACT -> ATCCCCATCAAATATATCACACTT
GGGTAGGACTCGGCCTTCACTCTG -> GGTAGGACTCGGCCTTCACTCTGA
TCCACTGCGCCTTGTTGGAAACGG -> CCACTGCGCCTTGTTGGAAACGGG
CACAAGGTAATAACCTGTTCTACC -> ACAAGGTAATAACCTGTTCTACCC
ACCTCGTAAACTGCCCAGACTTAA -> CCTCGTAAACTGCCCAGACTTAAA
GCCATAGAAGTTGGGTATCAGGCG -> CCATAGAAGTTGGGTATCAGGCGC
ACTTGCTCCATCCCCATCAAATAT -> CTTGCTCCATCCCCATCAAATATA
CCGATTCACGCAGCATCTCGAGCT -> CGATTCACGCAGCATCTCGAGCTA
GTGAATATTTCCTCTGGCGATTAC -> TGAATATTTCCTCTGGCGATTACA
CATTCGTGTCGTGGCCAACCTCGT -> ATTCGTGTCGTGGCCAACCTCGTA
AAAACATCCTCCCTTTCCATAGTT -> AAACATCCTCCCTTTCCATAGTTC
TCCCCATCAAATATATCACACTTA -> CCCCATCAAATATATCACACTTAT
CAGACGTTGTGAATTAGGCATCTC -> AGACGTTGTGAATTAGGCATCTCC
GCAGGAAAAATCAGTAATGATGGT -> CAGGAAAAATCAGTAATGATGGTT
CGAAGTTCGCCGTTCTGCTGGTAT -> GAAGTTCGCCGTTCTGCTGGTATT
CACACTTATTGGGTGACCACGGAC -> ACACTTATTGGGTGACCACGGACG
GCCCAAATGTAGAACGAAAACGGA -> CCCAAATGTAGAACGAAAACGGAG
GTGAGTCATTCATAGGTACAAAAC -> TGAGTCATTCATAGGTACAAAACA
TTTCTTTTCATGGGGTCATTGCCG -> TTCTTTTCATGGGGTCATTGCCGA
CTTTAAGCAATTTACTTGCTCCAT -> TTTAAGCAATTTACTTGCTCCATC
AATCGGGCGTCCCCATTAGTGTAT -> ATCGGGCGTCCCCATTAGTGTATG
GCACAGCAGGACCCGAAGGGAGCA -> CACAGCAGGACCCGAAGGGAGCAC
TAGAACCGAATCCCTAGACTCGTG -> AGAACCGAATCCCTAGACTCGTGA
TCGGCTGAGGTAGGAAGCCTCGAA -> CGGCTGAGGTAGGAAGCCTCGAAA
CCCTAGCCCAATTGTTCGACATTA -> CCTAGCCCAATTGTTCGACATTAT
TCCAAAGGCAGAAATAGAACCGAA -> CCAAAGGCAGAAATAGAACCGAAT
CAAGGAAACAGGGACAGGGCCGTC -> AAGGAAACAGGGACAGGGCCGTCG
TAGGCGTGTCATACAAGTCTTGCG -> AGGCGTGTCATACAAGTCTTGCGT
AACCAGCGCATCGGCAAGCAACGT -> ACCAGCGCATCGGCAAGCAACGTT
CCCGCGAGAAGCAATAATTAGAAC -> CCGCGAGAAGCAATAATTAGAACG
CCGATATCATCAAGTGGTGAAACG -> CGATATCATCAAGTGGTGAAACGT
TTAGGCATCTCCGGACGACCACTT -> TAGGCATCTCCGGACGACCACTTG
TGGTACCATTCGCGCATTGAGTCT -> GGTACCATTCGCGCATTGAGTCTT
CGTGCCTCACTAGAACTATGACTG -> GTGCCTCACTAGAACTATGACTGA
CCCCACTTTCTTTTCATGGGGTCA -> CCCACTTTCTTTTCATGGGGTCAT
AAACCAAGGCAAGGAAACAGGGAC -> AACCAAGGCAAGGAAACAGGGACA
TCGAGGGATGCTGGACGTAGGGCG -> CGAGGGATGCTGGACGTAGGGCGG
CCGTTCTGCTGGTATTGGGCTTAT -> CGTTCTGCTGGTATTGGGCTTATA
CGCGAGAAGCAATAATTAGAACGT -> GCGAGAAGCAATAATTAGAACGTT
AGGCTGCTTCCAGCAGCTACATGA -> GGCTGCTTCCAGCAGCTACATGAC
GAAACAGGGACAGGGCCGTCGCCG -> AAACAGGGACAGGGCCGTCGCCGA
AAGTTGGGTATCAGGCGCACAGTG -> AGTTGGGTATCAGGCGCACAGTGA
GACACCGCCTCCCTCGACAACTAA -> ACACCGCCTCCCTCGACAACTAAC
AAGCAATAATTAGAACGTTGGTGA -> AGCAATAATTAGAACGTTGGTGAG
AGGAGTGTTTAAAGGAGAGAGGCA -> GGAGTGTTTAAAGGAGAGAGGCAA
CAAGCAGGAAAAATCAGTAATGAT -> AAGCAGGAAAAATCAGTAATGATG
ATAGAACCGAATCCCTAGACTCGT -> TAGAACCGAATCCCTAGACTCGTG
CAACAATTTCCCCACTTTCTTTTC -> AACAATTTCCCCACTTTCTTTTCA
GTAAACTGCCCAGACTTAAAACCA -> TAAACTGCCCAGACTTAAAACCAA
CGGAACAAGCAGGAAAAATCAGTA -> GGAACAAGCAGGAAAAATCAGTAA
TAGAAATAAATGATGGACGTCATA -> AGAAATAAATGATGGACGTCATAG
AAGTAGAGTCTGGGATAGAGTATT -> AGTAGAGTCTGGGATAGAGTATTC
TGGACGTCATAGTCCGGTGGGCAC -> GGACGTCATAGTCCGGTGGGCACA
GGAGACGCCGGGATGGCCAGTGGC -> GAGACGCCGGGATGGCCAGTGGCC
GGCGTCCCCATTAGTGTATGGAAA -> GCGTCCCCATTAGTGTATGGAAAT
GAATTAGGCATCTCCGGACGACCA -> AATTAGGCATCTCCGGACGACCAC
AAGTGGTGAAACGTTTTTATGATC -> AGTGGTGAAACGTTTTTATGATCT
GCATCTCCGGACGACCACTTGAGT -> CATCTCCGGACGACCACTTGAGTC
CTCTCCAGCCCGGCAATAATGTGC -> TCTCCAGCCCGGCAATAATGTGCG
TTGAGCGACGCATTGGTGTCTGAT -> TGAGCGACGCATTGGTGTCTGATG
ATAGTCCACTGCGCCTTGTTGGAA -> TAGTCCACTGCGCCTTGTTGGAAA
AAACAGGGACAGGGCCGTCGCCGA -> AACAGGGACAGGGCCGTCGCCGAT
ATTCGCGCATTGAGTCTTCGAGCA -> TTCGCGCATTGAGTCTTCGAGCAC
CATTTGCGGTTAGATACACATAGG -> ATTTGCGGTTAGATACACATAGGG
CTTCGAAGTTCGCCGTTCTGCTGG -> TTCGAAGTTCGCCGTTCTGCTGGT
CATGGGGTCATTGCCGAGGGCTAA -> ATGGGGTCATTGCCGAGGGCTAAC
ATTTGCTATTGGCCATTAATCGCT -> TTTGCTATTGGCCATTAATCGCTT
TAATACTGCGTTGCGAGTCGGCTG -> AATACTGCGTTGCGAGTCGGCTGA
TGGGCACACCGCCTATGGAAAGCA -> GGGCACACCGCCTATGGAAAGCAT
AACCGGCCGACGGGTAGGACTCGG -> ACCGGCCGACGGGTAGGACTCGGC
CCAAGGCAAGGAAACAGGGACAGG -> CAAGGCAAGGAAACAGGGACAGGG
GGGTGACCACGGACGTGTATGACT -> GGTGACCACGGACGTGTATGACTC
TCGCATCATTCCTGTGCTAGCGGC -> CGCATCATTCCTGTGCTAGCGGCT
AGCAGCTACATGACTACGGCAGCT -> GCAGCTACATGACTACGGCAGCTT
CATGACTACGGCAGCTTCCCTAGA -> ATGACTACGGCAGCTTCCCTAGAC
ATATCATAATACTGCGTTGCGAGT -> TATCATAATACTGCGTTGCGAGTC
ACATCAAGCCTACTAATGTACGCA -> CATCAAGCCTACTAATGTACGCAG
GTCCAAGGAAAATCTGATTCGCGC -> TCCAAGGAAAATCTGATTCGCGCG
GGCTCTCCAGCCCGGCAATAATGT -> GCTCTCCAGCCCGGCAATAATGTG
CATTTGGCTTCCTTGATGCACCTA -> ATTTGGCTTCCTTGATGCACCTAA
GATGTTAATGAGTGAAATTCTCAG -> ATGTTAATGAGTGAAATTCTCAGA
AATAATGTGCGTGGTGCTTCAAAC -> ATAATGTGCGTGGTGCTTCAAACG
TTATGATCTCGCATCATTCCTGTG -> TATGATCTCGCATCATTCCTGTGC
CAGCAGCTACATGACTACGGCAGC -> AGCAGCTACATGACTACGGCAGCT
CCCGAAGGGAGCACCAACAATTTC -> CCGAAGGGAGCACCAACAATTTCC
TGTTGGAAACGGGGAAACCGGCCG -> GTTGGAAACGGGGAAACCGGCCGA
CCCTCGACAACTAACTCGACCATC -> CCTCGACAACTAACTCGACCATCC
AAGTTAGGGTTAGATTAATGGGAG -> AGTTAGGGTTAGATTAATGGGAGA
ATATCATCAAGTGGTGAAACGTTT -> TATCATCAAGTGGTGAAACGTTTT
TTTTCATGGGGTCATTGCCGAGGG -> TTTCATGGGGTCATTGCCGAGGGC
ACCTTCATACGATTTAATAGCGTA -> CCTTCATACGATTTAATAGCGTAA
GGGAAACCGGCCGACGGGTAGGAC -> GGAAACCGGCCGACGGGTAGGACT
GTATATCATAATACTGCGTTGCGA -> TATATCATAATACTGCGTTGCGAG
AACGACGATATATCGTGCCTCACT -> ACGACGATATATCGTGCCTCACTA
GGTGTCTGATGTTAATGAGTGAAA -> GTGTCTGATGTTAATGAGTGAAAT
CTCACTAGAACTATGACTGACTCG -> TCACTAGAACTATGACTGACTCGT
CACATAGGGAGTTACGGACCTACA -> ACATAGGGAGTTACGGACCTACAG
CTTTGCCAGACTTGGTAGGCGTGT -> TTTGCCAGACTTGGTAGGCGTGTC
ATGAGTGAAATTCTCAGACGTTGT -> TGAGTGAAATTCTCAGACGTTGTG
TAACTCGACCATCCGCCCAAATGT -> AACTCGACCATCCGCCCAAATGTA
ACCGGCCGACGGGTAGGACTCGGC -> CCGGCCGACGGGTAGGACTCGGCC
TGTAGGCGCTGCATTAACGACGAT -> GTAGGCGCTGCATTAACGACGATA
TAATTAGAACGTTGGTGAGTCATT -> AATTAGAACGTTGGTGAGTCATTC
GCGAGTAACGGAACAAGCAGGAAA -> CGAGTAACGGAACAAGCAGGAAAA
GGTGGCTAAGCTTCGAAAGTTGGC -> GTGGCTAAGCTTCGAAAGTTGGCG
TGCGAGTCGGCTGAGGTAGGAAGC -> GCGAGTCGGCTGAGGTAGGAAGCC
TTCCATAGTTCTGGAAGGAGTGTT -> TCCATAGTTCTGGAAGGAGTGTTT
CGTCATAGTCCGGTGGGCACATCG -> GTCATAGTCCGGTGGGCACATCGC
CATCTCCGGACGACCACTTGAGTC -> ATCTCCGGACGACCACTTGAGTCG
TGGCCCTAGCCCAATTGTTCGACA -> GGCCCTAGCCCAATTGTTCGACAT
ACATAGGGAGTTACGGACCTACAG -> CATAGGGAGTTACGGACCTACAGA
GGCATCTCCGGACGACCACTTGAG -> GCATCTCCGGACGACCACTTGAGT
TATATGTGAAGTAGAGTCTGGGAT -> ATATGTGAAGTAGAGTCTGGGATA
CGGGTCAGTATAACATGATTCGAG -> GGGTCAGTATAACATGATTCGAGG
TTACACTATACCAGTGCAATGAGC -> TACACTATACCAGTGCAATGAGCC
GCATTGGTGTCTGATGTTAATGAG -> CATTGGTGTCTGATGTTAATGAGT
CAAATGTAGAACGAAAACGGAGAG -> AAATGTAGAACGAAAACGGAGAGG
GACTTAAAACCAAGGCAAGGAAAC -> ACTTAAAACCAAGGCAAGGAAACA
TCGTCTTAAGAAACCAGCGCATCG -> CGTCTTAAGAAACCAGCGCATCGG
AAATGTAGAACGAAAACGGAGAGG -> AATGTAGAACGAAAACGGAGAGGG
AATAATTAGAACGTTGGTGAGTCA -> ATAATTAGAACGTTGGTGAGTCAT
GCTCCATCCCCATCAAATATATCA -> CTCCATCCCCATCAAATATATCAC
AATACTGCGTTGCGAGTCGGCTGA -> ATACTGCGTTGCGAGTCGGCTGAG
GTTTCTAACAGGTCTCACTAACTG -> TTTCTAACAGGTCTCACTAACTGA
TTACTTGCTCCATCCCCATCAAAT -> TACTTGCTCCATCCCCATCAAATA
TGTTTTGAATTGCATATCACTATG -> GTTTTGAATTGCATATCACTATGT
CGTGCCCGCGAGAAGCAATAATTA -> GTGCCCGCGAGAAGCAATAATTAG
GAGTTACGGACCTACAGACGGGTC -> AGTTACGGACCTACAGACGGGTCA
GACAGGGCCGTCGCCGATATCATC -> ACAGGGCCGTCGCCGATATCATCA
TGCTGGTATTGGGCTTATACCACG -> GCTGGTATTGGGCTTATACCACGG
TCGCCGATATCATCAAGTGGTGAA -> CGCCGATATCATCAAGTGGTGAAA
AGAAGTTGGGTATCAGGCGCACAG -> GAAGTTGGGTATCAGGCGCACAGT
CCAACCTCGTAAACTGCCCAGACT -> CAACCTCGTAAACTGCCCAGACTT
GGAAGGAGTGTTTAAAGGAGAGAG -> GAAGGAGTGTTTAAAGGAGAGAGG
CCTACTAATGTACGCAGGACGAAA -> CTACTAATGTACGCAGGACGAAAT
AGCAATAATTAGAACGTTGGTGAG -> GCAATAATTAGAACGTTGGTGAGT
GTAGGGCGGACGTGTCTAGCCGTA -> TAGGGCGGACGTGTCTAGCCGTAG
GGACGACCACTTGAGTCGACACAT -> GACGACCACTTGAGTCGACACATC
TTGCATTCGTGTCGTGGCCAACCT -> TGCATTCGTGTCGTGGCCAACCTC
GTTCCTGGTCGTAACGGGCGGTTC -> TTCCTGGTCGTAACGGGCGGTTCG
AGTTGGGTATCAGGCGCACAGTGA -> GTTGGGTATCAGGCGCACAGTGAA
AGCCGTAGAAATAAATGATGGACG -> GCCGTAGAAATAAATGATGGACGT
TATCAGAAATTCAGGCTGCTTCCA -> ATCAGAAATTCAGGCTGCTTCCAG
AGGAACAATCGGGCGTCCCCATTA -> GGAACAATCGGGCGTCCCCATTAG
AGTCGGCTGAGGTAGGAAGCCTCG -> GTCGGCTGAGGTAGGAAGCCTCGA
TCCTTTTATATGTGAAGTAGAGTC -> CCTTTTATATGTGAAGTAGAGTCT
CTGGCGATTACACTATACCAGTGC -> TGGCGATTACACTATACCAGTGCA
AGCGTAAAGACTTCACAAGGTAAT -> GCGTAAAGACTTCACAAGGTAATA
AAAAGCTCCTTTTATATGTGAAGT -> AAAGCTCCTTTTATATGTGAAGTA
ACGGATACCGCCTTGCATTCGTGT -> CGGATACCGCCTTGCATTCGTGTC
GCCGAGGGCTAACTTGTTTTGAAT -> CCGAGGGCTAACTTGTTTTGAATT
GCACAACTAGGGCGAGTAACGGAA -> CACAACTAGGGCGAGTAACGGAAC
CTAAGCTTCGAAAGTTGGCGTATA -> TAAGCTTCGAAAGTTGGCGTATAT
CGAGGGCTAACTTGTTTTGAATTG -> GAGGGCTAACTTGTTTTGAATTGC
CACGCAGCATCTCGAGCTATGCGT -> ACGCAGCATCTCGAGCTATGCGTA
TAAATGATGGACGTCATAGTCCGG -> AAATGATGGACGTCATAGTCCGGT
ATACCAGTGCAATGAGCCTTTAAG -> TACCAGTGCAATGAGCCTTTAAGC
GTGTCGTGGCCAACCTCGTAAACT -> TGTCGTGGCCAACCTCGTAAACTG
AGCATTTGCGGTTAGATACACATA -> GCATTTGCGGTTAGATACACATAG
CGGCTGAGGTAGGAAGCCTCGAAA -> GGCTGAGGTAGGAAGCCTCGAAAT
GCCTACTAATGTACGCAGGACGAA -> CCTACTAATGTACGCAGGACGAAA
CGTCCCCATTAGTGTATGGAAATA -> GTCCCCATTAGTGTATGGAAATAT
CTCGAAATTTTAGGAATGGTACCT -> TCGAAATTTTAGGAATGGTACCTT
GTGGCTAAGCTTCGAAAGTTGGCG -> TGGCTAAGCTTCGAAAGTTGGCGT
AGGGCTAACTTGTTTTGAATTGCA -> GGGCTAACTTGTTTTGAATTGCAT
ATATTATCTTGATAGGGCACAGCA -> TATTATCTTGATAGGGCACAGCAG
TGCTTCAAACGTCTTACTTCGAAG -> GCTTCAAACGTCTTACTTCGAAGT
AACCTCGTAAACTGCCCAGACTTA -> ACCTCGTAAACTGCCCAGACTTAA
TTTCCTCTGGCGATTACACTATAC -> TTCCTCTGGCGATTACACTATACC
TAGAAGTTGGGTATCAGGCGCACA -> AGAAGTTGGGTATCAGGCGCACAG
TGAGGAACAATCGGGCGTCCCCAT -> GAGGAACAATCGGGCGTCCCCATT
GTCATAGTCCGGTGGGCACATCGC -> TCATAGTCCGGTGGGCACATCGCC
GTCGACACATCAAGCCTACTAATG -> TCGACACATCAAGCCTACTAATGT
GCTAGCGGCTTAAGTTAGGGTTAG -> CTAGCGGCTTAAGTTAGGGTTAGA
ATAGTTCTGGAAGGAGTGTTTAAA -> TAGTTCTGGAAGGAGTGTTTAAAG
CGTGAGATTTCGTGCACGTACAGT -> GTGAGATTTCGTGCACGTACAGTG
AAACGGGGAAACCGGCCGACGGGT -> AACGGGGAAACCGGCCGACGGGTA
CGAGAAGCAATAATTAGAACGTTG -> GAGAAGCAATAATTAGAACGTTGG
GCTCCTTTTATATGTGAAGTAGAG -> CTCCTTTTATATGTGAAGTAGAGT
GGGTTGGAACGTTCCTGGTCGTAA -> GGTTGGAACGTTCCTGGTCGTAAC
TGCATATCACTATGTTTGAGCGAC -> GCATATCACTATGTTTGAGCGACG
TTCACGCAGCATCTCGAGCTATGC -> TCACGCAGCATCTCGAGCTATGCG
GTCGTGAATATTTCCTCTGGCGAT -> TCGTGAATATTTCCTCTGGCGATT
GTTCTGGAAGGAGTGTTTAAAGGA -> TTCTGGAAGGAGTGTTTAAAGGAG
GTTGGTGAGTCATTCATAGGTACA -> TTGGTGAGTCATTCATAGGTACAA
GTATCAGAAATTCAGGCTGCTTCC -> TATCAGAAATTCAGGCTGCTTCCA
TCTGACATGTGCGGGTGGCTAAGC -> CTGACATGTGCGGGTGGCTAAGCT
TACCATTCGCGCATTGAGTCTTCG -> ACCATTCGCGCATTGAGTCTTCGA
CCCTAGACTCGTGACTAGGTATCA -> CCTAGACTCGTGACTAGGTATCAG
ATGTAGAACGAAAACGGAGAGGGG -> TGTAGAACGAAAACGGAGAGGGGT
CCAGCGCATCGGCAAGCAACGTTA -> CAGCGCATCGGCAAGCAACGTTAT
TAAAACCAAGGCAAGGAAACAGGG -> AAAACCAAGGCAAGGAAACAGGGA
CAGTATAACATGATTCGAGGGATG -> AGTATAACATGATTCGAGGGATGC
AAATAGTGCGTGAGATTTCGTGCA -> AATAGTGCGTGAGATTTCGTGCAC
GGATGTCAAAACGCCAATGCAAAG -> GATGTCAAAACGCCAATGCAAAGA
GGCTCACGTACACTGAGTTGTAGG -> GCTCACGTACACTGAGTTGTAGGC
GCGTAAAGACTTCACAAGGTAATA -> CGTAAAGACTTCACAAGGTAATAA
AGTTGGCGTATATCATAATACTGC -> GTTGGCGTATATCATAATACTGCG
CTAGACTCGTGACTAGGTATCAGA -> TAGACTCGTGACTAGGTATCAGAA
AAGACTTCACAAGGTAATAACCTG -> AGACTTCACAAGGTAATAACCTGT
TCAGGCGCACAGTGAAAAGCTCCT -> CAGGCGCACAGTGAAAAGCTCCTT
TACTGCGTTGCGAGTCGGCTGAGG -> ACTGCGTTGCGAGTCGGCTGAGGT
AAACGTCTTACTTCGAAGTTCGCC -> AACGTCTTACTTCGAAGTTCGCCG
GGCGAGTAACGGAACAAGCAGGAA -> GCGAGTAACGGAACAAGCAGGAAA
ATGCACCTAAATAGTGCGTGAGAT -> TGCACCTAAATAGTGCGTGAGATT
CCTAGACTCGTGACTAGGTATCAG -> CTAGACTCGTGACTAGGTATCAGA
CTCGACAACTAACTCGACCATCCG -> TCGACAACTAACTCGACCATCCGC
CGTATATCATAATACTGCGTTGCG -> GTATATCATAATACTGCGTTGCGA
TTTTATATGTGAAGTAGAGTCTGG -> TTTATATGTGAAGTAGAGTCTGGG
CAATGAGCCTTTAAGCAATTTACT -> AATGAGCCTTTAAGCAATTTACTT
TGAGATTTCGTGCACGTACAGTGA -> GAGATTTCGTGCACGTACAGTGAG
TTCACTCTGGTACCATTCGCGCAT -> TCACTCTGGTACCATTCGCGCATT
GTGCTTCAAACGTCTTACTTCGAA -> TGCTTCAAACGTCTTACTTCGAAG
GACATTATAGGCTCTCCAGCCCGG -> ACATTATAGGCTCTCCAGCCCGGC
TTAATAGCGTAAAGACTTCACAAG -> TAATAGCGTAAAGACTTCACAAGG
CCAGCAGCTACATGACTACGGCAG -> CAGCAGCTACATGACTACGGCAGC
TCGCACAATTCACTCTGGTACCAT -> CGCACAATTCACTCTGGTACCATT
ATAGGATGTTGGCTCACGTACACT -> TAGGATGTTGGCTCACGTACACTG
GGTTCACTCTTTGCCAGACTTGGT -> GTTCACTCTTTGCCAGACTTGGTA
ATCGCCATAGAAGTTGGGTATCAG -> TCGCCATAGAAGTTGGGTATCAGG
GATTCGAGGGATGCTGGACGTAGG -> ATTCGAGGGATGCTGGACGTAGGG
CGAGTAACGGAACAAGCAGGAAAA -> GAGTAACGGAACAAGCAGGAAAAA
TAGGATGTTGGCTCACGTACACTG -> AGGATGTTGGCTCACGTACACTGA
TGTTCTACCCTAGCATTTGCGGTT -> GTTCTACCCTAGCATTTGCGGTTA
GTGCAATGAGCCTTTAAGCAATTT -> TGCAATGAGCCTTTAAGCAATTTA
GCATTTGCGGTTAGATACACATAG -> CATTTGCGGTTAGATACACATAGG
AGCATCTCGAGCTATGCGTATAAG -> GCATCTCGAGCTATGCGTATAAGC
AATAGCGTAAAGACTTCACAAGGT -> ATAGCGTAAAGACTTCACAAGGTA
ACTTAAAACCAAGGCAAGGAAACA -> CTTAAAACCAAGGCAAGGAAACAG
TCAAGCCTACTAATGTACGCAGGA -> CAAGCCTACTAATGTACGCAGGAC
TAGTGTATGGAAATATAGGATGTT -> AGTGTATGGAAATATAGGATGTTG
ATATATCGTGCCTCACTAGAACTA -> TATATCGTGCCTCACTAGAACTAT
GATATCATCAAGTGGTGAAACGTT -> ATATCATCAAGTGGTGAAACGTTT
AGGGATGCTGGACGTAGGGCGGAC -> GGGATGCTGGACGTAGGGCGGACG
CCCAAATGTAGAACGAAAACGGAG -> CCAAATGTAGAACGAAAACGGAGA
GAACGAAAACGGAGAGGGGTTGGA -> AACGAAAACGGAGAGGGGTTGGAA
AGGCGCTGCATTAACGACGATATA -> GGCGCTGCATTAACGACGATATAT
CCGACGGGTAGGACTCGGCCTTCA -> CGACGGGTAGGACTCGGCCTTCAC
CGACAACTAACTCGACCATCCGCC -> GACAACTAACTCGACCATCCGCCC
ACATGATTCGAGGGATGCTGGACG -> CATGATTCGAGGGATGCTGGACGT
GGGTGGCTAAGCTTCGAAAGTTGG -> GGTGGCTAAGCTTCGAAAGTTGGC
ATCGGGCGTCCCCATTAGTGTATG -> TCGGGCGTCCCCATTAGTGTATGG
GAGAGGCAACAACCGCTCGTCTTA -> AGAGGCAACAACCGCTCGTCTTAA
CGGAGAGGGGTTGGAACGTTCCTG -> GGAGAGGGGTTGGAACGTTCCTGG
ATCGGCAAGCAACGTTATATTATC -> TCGGCAAGCAACGTTATATTATCT
AGTTACGGACCTACAGACGGGTCA -> GTTACGGACCTACAGACGGGTCAG
TACGCAGGACGAAATCTATATTAA -> ACGCAGGACGAAATCTATATTAAT
CATTGGTGTCTGATGTTAATGAGT -> ATTGGTGTCTGATGTTAATGAGTG
ACACCGCCTATGGAAAGCATTTGG -> CACCGCCTATGGAAAGCATTTGGC
GTTGTAGGCGCTGCATTAACGACG -> TTGTAGGCGCTGCATTAACGACGA
GGCGGACGTGTCTAGCCGTAGAAA -> GCGGACGTGTCTAGCCGTAGAAAT
TGACTAGGTATCAGAAATTCAGGC -> GACTAGGTATCAGAAATTCAGGCT
CATGTGCGGGTGGCTAAGCTTCGA -> ATGTGCGGGTGGCTAAGCTTCGAA
TAGGCTCTCCAGCCCGGCAATAAT -> AGGCTCTCCAGCCCGGCAATAATG
TGCCCAGACTTAAAACCAAGGCAA -> GCCCAGACTTAAAACCAAGGCAAG
TAGTCCACTGCGCCTTGTTGGAAA -> AGTCCACTGCGCCTTGTTGGAAAC
AAATAGAACCGAATCCCTAGACTC -> AATAGAACCGAATCCCTAGACTCG
TTGGAAACGGGGAAACCGGCCGAC -> TGGAAACGGGGAAACCGGCCGACG
ATGACTCTGTTTGATTGCCGATTC -> TGACTCTGTTTGATTGCCGATTCA
TGCACGTACAGTGAGGAACAATCG -> GCACGTACAGTGAGGAACAATCGG
GCTAACTTGTTTTGAATTGCATAT -> CTAACTTGTTTTGAATTGCATATC
CGTGACACCGCCTCCCTCGACAAC -> GTGACACCGCCTCCCTCGACAACT
GCCTCACTAGAACTATGACTGACT -> CCTCACTAGAACTATGACTGACTC
GGCGTGCCCGCGAGAAGCAATAAT -> GCGTGCCCGCGAGAAGCAATAATT
ATCACACTTATTGGGTGACCACGG -> TCACACTTATTGGGTGACCACGGA
GCGTGGTGCTTCAAACGTCTTACT -> CGTGGTGCTTCAAACGTCTTACTT
ACTCGTCCAAGGAAAATCTGATTC -> CTCGTCCAAGGAAAATCTGATTCG
GGATGGCCAGTGGCCCTAGCCCAA -> GATGGCCAGTGGCCCTAGCCCAAT
TGGTGTCTGATGTTAATGAGTGAA -> GGTGTCTGATGTTAATGAGTGAAA
GTTCTCAAAGGCACGTCGTGAATA -> TTCTCAAAGGCACGTCGTGAATAT
TTGGGTGACCACGGACGTGTATGA -> TGGGTGACCACGGACGTGTATGAC
ACCGAATCCCTAGACTCGTGACTA -> CCGAATCCCTAGACTCGTGACTAG
TCGTGGCCAACCTCGTAAACTGCC -> CGTGGCCAACCTCGTAAACTGCCC
CTAGCATTTGCGGTTAGATACACA -> TAGCATTTGCGGTTAGATACACAT
AATGATGGACGTCATAGTCCGGTG -> ATGATGGACGTCATAGTCCGGTGG
AAACATCCTCCCTTTCCATAGTTC -> AACATCCTCCCTTTCCATAGTTCT
AACATGATTCGAGGGATGCTGGAC -> ACATGATTCGAGGGATGCTGGACG
CAATTTACTTGCTCCATCCCCATC -> AATTTACTTGCTCCATCCCCATCA
ACGGGGAAACCGGCCGACGGGTAG -> CGGGGAAACCGGCCGACGGGTAGG
GTCTTACTTCGAAGTTCGCCGTTC -> TCTTACTTCGAAGTTCGCCGTTCT
GTCAGTATAACATGATTCGAGGGA -> TCAGTATAACATGATTCGAGGGAT
GCTGCATTAACGACGATATATCGT -> CTGCATTAACGACGATATATCGTG
TACCACGGCGTGCCCGCGAGAAGC -> ACCACGGCGTGCCCGCGAGAAGCA
CAAAGGCAGAAATAGAACCGAATC -> AAAGGCAGAAATAGAACCGAATCC
ACCACTTGAGTCGACACATCAAGC -> CCACTTGAGTCGACACATCAAGCC
CAAGGTAATAACCTGTTCTACCCT -> AAGGTAATAACCTGTTCTACCCTA
CGTCCAAGGAAAATCTGATTCGCG -> GTCCAAGGAAAATCTGATTCGCGC
ACTCTGGTACCATTCGCGCATTGA -> CTCTGGTACCATTCGCGCATTGAG
GTACAGTGAGGAACAATCGGGCGT -> TACAGTGAGGAACAATCGGGCGTC
CTTCCAGCAGCTACATGACTACGG -> TTCCAGCAGCTACATGACTACGGC
CTAAATAGTGCGTGAGATTTCGTG -> TAAATAGTGCGTGAGATTTCGTGC
GACTAAGGATGTCAAAACGCCAAT -> ACTAAGGATGTCAAAACGCCAATG
AAACGCCAATGCAAAGACTGGGGA -> AACGCCAATGCAAAGACTGGGGAG
CGGATACCGCCTTGCATTCGTGTC -> GGATACCGCCTTGCATTCGTGTCG
CATTCCTGTGCTAGCGGCTTAAGT -> ATTCCTGTGCTAGCGGCTTAAGTT
ACCCGCACAACTAGGGCGAGTAAC -> CCCGCACAACTAGGGCGAGTAACG
AAGTTGGCGTATATCATAATACTG -> AGTTGGCGTATATCATAATACTGC
CGCAGCATCTCGAGCTATGCGTAT -> GCAGCATCTCGAGCTATGCGTATA
CTTGAGTCGACACATCAAGCCTAC -> TTGAGTCGACACATCAAGCCTACT
CAGGGACAGGGCCGTCGCCGATAT -> AGGGACAGGGCCGTCGCCGATATC
TTAAGTTAGGGTTAGATTAATGGG -> TAAGTTAGGGTTAGATTAATGGGA
ATAGAGTATTCACCGACTAAGGAT -> TAGAGTATTCACCGACTAAGGATG
AACGTTATATTATCTTGATAGGGC -> ACGTTATATTATCTTGATAGGGCA
TTAGATACACATAGGGAGTTACGG -> TAGATACACATAGGGAGTTACGGA
TATCATCAAGTGGTGAAACGTTTT -> ATCATCAAGTGGTGAAACGTTTTT
ATATGTGAAGTAGAGTCTGGGATA -> TATGTGAAGTAGAGTCTGGGATAG
ATTGCCGAGGGCTAACTTGTTTTG -> TTGCCGAGGGCTAACTTGTTTTGA
TTGTAGGCGCTGCATTAACGACGA -> TGTAGGCGCTGCATTAACGACGAT
ACTTGGTAGGCGTGTCATACAAGT -> CTTGGTAGGCGTGTCATACAAGTC
AATTCACTCTGGTACCATTCGCGC -> ATTCACTCTGGTACCATTCGCGCA
CTCCGGACGACCACTTGAGTCGAC -> TCCGGACGACCACTTGAGTCGACA
CACTATACCAGTGCAATGAGCCTT -> ACTATACCAGTGCAATGAGCCTTT
CGAAATCTATATTAATAGTCCACT -> GAAATCTATATTAATAGTCCACTG
ACAAAACATCCTCCCTTTCCATAG -> CAAAACATCCTCCCTTTCCATAGT
AGGTATCAGAAATTCAGGCTGCTT -> GGTATCAGAAATTCAGGCTGCTTC
GAGAAGCAATAATTAGAACGTTGG -> AGAAGCAATAATTAGAACGTTGGT
TATAAGCGCGAATGATTTGCTATT -> ATAAGCGCGAATGATTTGCTATTG
AGGATGTTGGCTCACGTACACTGA -> GGATGTTGGCTCACGTACACTGAG
TAATGAGTGAAATTCTCAGACGTT -> AATGAGTGAAATTCTCAGACGTTG
CTGGTATTGGGCTTATACCACGGC -> TGGTATTGGGCTTATACCACGGCG
TGGCCAGTGGCCCTAGCCCAATTG -> GGCCAGTGGCCCTAGCCCAATTGT
GGCACGTCGTGAATATTTCCTCTG -> GCACGTCGTGAATATTTCCTCTGG
ACGCAGGACGAAATCTATATTAAT -> CGCAGGACGAAATCTATATTAATA
CATTATAGGCTCTCCAGCCCGGCA -> ATTATAGGCTCTCCAGCCCGGCAA
AAATCAGTAATGATGGTTCACTCT -> AATCAGTAATGATGGTTCACTCTT
ACCAGCGCATCGGCAAGCAACGTT -> CCAGCGCATCGGCAAGCAACGTTA
GGAAACAGGGACAGGGCCGTCGCC -> GAAACAGGGACAGGGCCGTCGCCG
CTACATGACTACGGCAGCTTCCCT -> TACATGACTACGGCAGCTTCCCTA
ACAATTCACTCTGGTACCATTCGC -> CAATTCACTCTGGTACCATTCGCG
TTCCTCTGGCGATTACACTATACC -> TCCTCTGGCGATTACACTATACCA
CTGCTTCCAGCAGCTACATGACTA -> TGCTTCCAGCAGCTACATGACTAC
AGGGACAGGGCCGTCGCCGATATC -> GGGACAGGGCCGTCGCCGATATCA
AAATAAATGATGGACGTCATAGTC -> AATAAATGATGGACGTCATAGTCC
CAACGGATACCGCCTTGCATTCGT -> AACGGATACCGCCTTGCATTCGTG
ACGATATATCGTGCCTCACTAGAA -> CGATATATCGTGCCTCACTAGAAC
CGGTTCGCCTCGCACAATTCACTC -> GGTTCGCCTCGCACAATTCACTCT
GGTAGGCGTGTCATACAAGTCTTG -> GTAGGCGTGTCATACAAGTCTTGC
TATCACACTTATTGGGTGACCACG -> ATCACACTTATTGGGTGACCACGG
ACACATCAAGCCTACTAATGTACG -> CACATCAAGCCTACTAATGTACGC
CAACTAACTCGACCATCCGCCCAA -> AACTAACTCGACCATCCGCCCAAA
CTGAGGTAGGAAGCCTCGAAATTT -> TGAGGTAGGAAGCCTCGAAATTTT
GATGGGCACACCGCCTATGGAAAG -> ATGGGCACACCGCCTATGGAAAGC
GTGCGGGTGGCTAAGCTTCGAAAG -> TGCGGGTGGCTAAGCTTCGAAAGT
GTCATTGCCGAGGGCTAACTTGTT -> TCATTGCCGAGGGCTAACTTGTTT
CCTCGCACAATTCACTCTGGTACC -> CTCGCACAATTCACTCTGGTACCA
CTCGCATCATTCCTGTGCTAGCGG -> TCGCATCATTCCTGTGCTAGCGGC
ACAAGTCTTGCGTGACACCGCCTC -> CAAGTCTTGCGTGACACCGCCTCC
GAGTCTGGGATAGAGTATTCACCG -> AGTCTGGGATAGAGTATTCACCGA
CGGACGTGTATGACTCTGTTTGAT -> GGACGTGTATGACTCTGTTTGATT
GATAGGGCACAGCAGGACCCGAAG -> ATAGGGCACAGCAGGACCCGAAGG
GCAATAATTAGAACGTTGGTGAGT -> CAATAATTAGAACGTTGGTGAGTC
TACTTGCTCCATCCCCATCAAATA -> ACTTGCTCCATCCCCATCAAATAT
TTCGACATTATAGGCTCTCCAGCC -> TCGACATTATAGGCTCTCCAGCCC
CTGGAAGGAGTGTTTAAAGGAGAG -> TGGAAGGAGTGTTTAAAGGAGAGA
ACGTAGGGCGGACGTGTCTAGCCG -> CGTAGGGCGGACGTGTCTAGCCGT
CGACGGGTAGGACTCGGCCTTCAC -> GACGGGTAGGACTCGGCCTTCACT
GAAGTTCGCCGTTCTGCTGGTATT -> AAGTTCGCCGTTCTGCTGGTATTG
TAGTCCGGTGGGCACATCGCCATA -> AGTCCGGTGGGCACATCGCCATAG
CGATTTAATAGCGTAAAGACTTCA -> GATTTAATAGCGTAAAGACTTCAC
CTCGTCTTAAGAAACCAGCGCATC -> TCGTCTTAAGAAACCAGCGCATCG
TGGGATAGAGTATTCACCGACTAA -> GGGATAGAGTATTCACCGACTAAG
ACGTTTTTATGATCTCGCATCATT -> CGTTTTTATGATCTCGCATCATTC
ATATTTCCTCTGGCGATTACACTA -> TATTTCCTCTGGCGATTACACTAT
CCACTTTCTTTTCATGGGGTCATT -> CACTTTCTTTTCATGGGGTCATTG
TATGACTCTGTTTGATTGCCGATT -> ATGACTCTGTTTGATTGCCGATTC
GCTTCGAAAGTTGGCGTATATCAT -> CTTCGAAAGTTGGCGTATATCATA
CATTAACGACGATATATCGTGCCT -> ATTAACGACGATATATCGTGCCTC
GAAATATAGGATGTTGGCTCACGT -> AAATATAGGATGTTGGCTCACGTA
TCGTGCCTCACTAGAACTATGACT -> CGTGCCTCACTAGAACTATGACTG
ATCGTGCCTCACTAGAACTATGAC -> TCGTGCCTCACTAGAACTATGACT
CAGGACCCGAAGGGAGCACCAACA -> AGGACCCGAAGGGAGCACCAACAA
TCATTGCCGAGGGCTAACTTGTTT -> CATTGCCGAGGGCTAACTTGTTTT
CGGGTAGGACTCGGCCTTCACTCT -> GGGTAGGACTCGGCCTTCACTCTG
CAAACGTCTTACTTCGAAGTTCGC -> AAACGTCTTACTTCGAAGTTCGCC
CGGCAATAATGTGCGTGGTGCTTC -> GGCAATAATGTGCGTGGTGCTTCA
AATGTAGAACGAAAACGGAGAGGG -> ATGTAGAACGAAAACGGAGAGGGG
CAAAACGCCAATGCAAAGACTGGG -> AAAACGCCAATGCAAAGACTGGGG
ACGCAGCATCTCGAGCTATGCGTA -> CGCAGCATCTCGAGCTATGCGTAT
GCACATCGCCATAGAAGTTGGGTA -> CACATCGCCATAGAAGTTGGGTAT
GAGTGAAATTCTCAGACGTTGTGA -> AGTGAAATTCTCAGACGTTGTGAA
CACTATGTTTGAGCGACGCATTGG -> ACTATGTTTGAGCGACGCATTGGT
ATTCAGGCTGCTTCCAGCAGCTAC -> TTCAGGCTGCTTCCAGCAGCTACA
AAGCCTCGAAATTTTAGGAATGGT -> AGCCTCGAAATTTTAGGAATGGTA
GGACGTGTATGACTCTGTTTGATT -> GACGTGTATGACTCTGTTTGATTG
TCTATATTAATAGTCCACTGCGCC -> CTATATTAATAGTCCACTGCGCCT
AGCTATGCGTATAAGCGCGAATGA -> GCTATGCGTATAAGCGCGAATGAT
ACGAAAACGGAGAGGGGTTGGAAC -> CGAAAACGGAGAGGGGTTGGAACG
TGAAAAGCTCCTTTTATATGTGAA -> GAAAAGCTCCTTTTATATGTGAAG
GGCAAGCAACGTTATATTATCTTG -> GCAAGCAACGTTATATTATCTTGA
GTTAATGAGTGAAATTCTCAGACG -> TTAATGAGTGAAATTCTCAGACGT
TCTGGTACCATTCGCGCATTGAGT -> CTGGTACCATTCGCGCATTGAGTC
AAGCAGGAAAAATCAGTAATGATG -> AGCAGGAAAAATCAGTAATGATGG
TTTTATGATCTCGCATCATTCCTG -> TTTATGATCTCGCATCATTCCTGT
ATGGGAGACGCCGGGATGGCCAGT -> TGGGAGACGCCGGGATGGCCAGTG
CTAGGGCGAGTAACGGAACAAGCA -> TAGGGCGAGTAACGGAACAAGCAG
TAGCCGTAGAAATAAATGATGGAC -> AGCCGTAGAAATAAATGATGGACG
GCGTATATCATAATACTGCGTTGC -> CGTATATCATAATACTGCGTTGCG
GTACCATTCGCGCATTGAGTCTTC -> TACCATTCGCGCATTGAGTCTTCG
TAGGACTCGGCCTTCACTCTGACA -> AGGACTCGGCCTTCACTCTGACAT
CCATCAAATATATCACACTTATTG -> CATCAAATATATCACACTTATTGG
AACTTGTTTTGAATTGCATATCAC -> ACTTGTTTTGAATTGCATATCACT
TGCCCGCGAGAAGCAATAATTAGA -> GCCCGCGAGAAGCAATAATTAGAA
CTGTGCTAGCGGCTTAAGTTAGGG -> TGTGCTAGCGGCTTAAGTTAGGGT
TGACTACGGCAGCTTCCCTAGACC -> GACTACGGCAGCTTCCCTAGACCC
CACACCGCCTATGGAAAGCATTTG -> ACACCGCCTATGGAAAGCATTTGG
ATCTGATTCGCGCGGTTTCTAACA -> TCTGATTCGCGCGGTTTCTAACAG
GATCTCGCATCATTCCTGTGCTAG -> ATCTCGCATCATTCCTGTGCTAGC
ATGACTGACTCGTCCAAGGAAAAT -> TGACTGACTCGTCCAAGGAAAATC
CATAGGTACAAAACATCCTCCCTT -> ATAGGTACAAAACATCCTCCCTTT
AAGGGAGCACCAACAATTTCCCCA -> AGGGAGCACCAACAATTTCCCCAC
ACAATTTCCCCACTTTCTTTTCAT -> CAATTTCCCCACTTTCTTTTCATG
GTCGGCTGAGGTAGGAAGCCTCGA -> TCGGCTGAGGTAGGAAGCCTCGAA
AAGCTTCGAAAGTTGGCGTATATC -> AGCTTCGAAAGTTGGCGTATATCA
TGCTCCATCCCCATCAAATATATC -> GCTCCATCCCCATCAAATATATCA
TAGGGCACAGCAGGACCCGAAGGG -> AGGGCACAGCAGGACCCGAAGGGA
TCAAAGGCACGTCGTGAATATTTC -> CAAAGGCACGTCGTGAATATTTCC
CTACGGCAGCTTCCCTAGACCCGC -> TACGGCAGCTTCCCTAGACCCGCA
ACTTGAGTCGACACATCAAGCCTA -> CTTGAGTCGACACATCAAGCCTAC
GAAATCTATATTAATAGTCCACTG -> AAATCTATATTAATAGTCCACTGC
ATTATAGGCTCTCCAGCCCGGCAA -> TTATAGGCTCTCCAGCCCGGCAAT
GTCCACTGCGCCTTGTTGGAAACG -> TCCACTGCGCCTTGTTGGAAACGG
GGTAGGAAGCCTCGAAATTTTAGG -> GTAGGAAGCCTCGAAATTTTAGGA
TAGGAATGGTACCTTCATACGATT -> AGGAATGGTACCTTCATACGATTT
TAAGTTAGGGTTAGATTAATGGGA -> AAGTTAGGGTTAGATTAATGGGAG
TGCAATGAGCCTTTAAGCAATTTA -> GCAATGAGCCTTTAAGCAATTTAC
ACCGCTCGTCTTAAGAAACCAGCG -> CCGCTCGTCTTAAGAAACCAGCGC
CTGATGTTAATGAGTGAAATTCTC -> TGATGTTAATGAGTGAAATTCTCA
GACGCCGGGATGGCCAGTGGCCCT -> ACGCCGGGATGGCCAGTGGCCCTA
GAGCACCAACAATTTCCCCACTTT -> AGCACCAACAATTTCCCCACTTTC
CTGACTCGTCCAAGGAAAATCTGA -> TGACTCGTCCAAGGAAAATCTGAT
TCTCGCATCATTCCTGTGCTAGCG -> CTCGCATCATTCCTGTGCTAGCGG
ATTATCTTGATAGGGCACAGCAGG -> TTATCTTGATAGGGCACAGCAGGA
AAACTGCCCAGACTTAAAACCAAG -> AACTGCCCAGACTTAAAACCAAGG
GACTTGGTAGGCGTGTCATACAAG -> ACTTGGTAGGCGTGTCATACAAGT
ACGGAACAAGCAGGAAAAATCAGT -> CGGAACAAGCAGGAAAAATCAGTA
CCTTCACTCTGACATGTGCGGGTG -> CTTCACTCTGACATGTGCGGGTGG
CCAAATGTAGAACGAAAACGGAGA -> CAAATGTAGAACGAAAACGGAGAG
TCGACAACTAACTCGACCATCCGC -> CGACAACTAACTCGACCATCCGCC
TCACCGACTAAGGATGTCAAAACG -> CACCGACTAAGGATGTCAAAACGC
GTGGTGAAACGTTTTTATGATCTC -> TGGTGAAACGTTTTTATGATCTCG
CGCCGGGATGGCCAGTGGCCCTAG -> GCCGGGATGGCCAGTGGCCCTAGC
CAAGTGGTGAAACGTTTTTATGAT -> AAGTGGTGAAACGTTTTTATGATC
TTAAGAAACCAGCGCATCGGCAAG -> TAAGAAACCAGCGCATCGGCAAGC
AATTCAGGCTGCTTCCAGCAGCTA -> ATTCAGGCTGCTTCCAGCAGCTAC
TCGTGACTAGGTATCAGAAATTCA -> CGTGACTAGGTATCAGAAATTCAG
GCGGTTTCTAACAGGTCTCACTAA -> CGGTTTCTAACAGGTCTCACTAAC
GCTTCAAACGTCTTACTTCGAAGT -> CTTCAAACGTCTTACTTCGAAGTT
GGGACAGGGCCGTCGCCGATATCA -> GGACAGGGCCGTCGCCGATATCAT
AACTGCCCAGACTTAAAACCAAGG -> ACTGCCCAGACTTAAAACCAAGGC
CCCCATCAAATATATCACACTTAT -> CCCATCAAATATATCACACTTATT
GTAGGACTCGGCCTTCACTCTGAC -> TAGGACTCGGCCTTCACTCTGACA
ATAAGCGCGAATGATTTGCTATTG -> TAAGCGCGAATGATTTGCTATTGG
AGGCATCTCCGGACGACCACTTGA -> GGCATCTCCGGACGACCACTTGAG
TCACACTTATTGGGTGACCACGGA -> CACACTTATTGGGTGACCACGGAC
GAGAGGGGTTGGAACGTTCCTGGT -> AGAGGGGTTGGAACGTTCCTGGTC
CAAGGAAAATCTGATTCGCGCGGT -> AAGGAAAATCTGATTCGCGCGGTT
GATATATCGTGCCTCACTAGAACT -> ATATATCGTGCCTCACTAGAACTA
TGTAGAACGAAAACGGAGAGGGGT -> GTAGAACGAAAACGGAGAGGGGTT
GGGAGCACCAACAATTTCCCCACT -> GGAGCACCAACAATTTCCCCACTT
TTGATAGGGCACAGCAGGACCCGA -> TGATAGGGCACAGCAGGACCCGAA
AAGGCACGTCGTGAATATTTCCTC -> AGGCACGTCGTGAATATTTCCTCT
CTCGCACAATTCACTCTGGTACCA -> TCGCACAATTCACTCTGGTACCAT
CGCCGTTCTGCTGGTATTGGGCTT -> GCCGTTCTGCTGGTATTGGGCTTA
TGGCCAACCTCGTAAACTGCCCAG -> GGCCAACCTCGTAAACTGCCCAGA
ACGGCGTGCCCGCGAGAAGCAATA -> CGGCGTGCCCGCGAGAAGCAATAA
TCTCAGACGTTGTGAATTAGGCAT -> CTCAGACGTTGTGAATTAGGCATC
GGCAGAAATAGAACCGAATCCCTA -> GCAGAAATAGAACCGAATCCCTAG
TGGCTAAGCTTCGAAAGTTGGCGT -> GGCTAAGCTTCGAAAGTTGGCGTA
GACGACCACTTGAGTCGACACATC -> ACGACCACTTGAGTCGACACATCA
AAATCTATATTAATAGTCCACTGC -> AATCTATATTAATAGTCCACTGCG
CACTCTGGTACCATTCGCGCATTG -> ACTCTGGTACCATTCGCGCATTGA
GGTGCTTCAAACGTCTTACTTCGA -> GTGCTTCAAACGTCTTACTTCGAA
TTCATGGGGTCATTGCCGAGGGCT -> TCATGGGGTCATTGCCGAGGGCTA
AGCAGGAAAAATCAGTAATGATGG -> GCAGGAAAAATCAGTAATGATGGT
AATCAGTAATGATGGTTCACTCTT -> ATCAGTAATGATGGTTCACTCTTT
CTATGTTTGAGCGACGCATTGGTG -> TATGTTTGAGCGACGCATTGGTGT
ATGTACGCAGGACGAAATCTATAT -> TGTACGCAGGACGAAATCTATATT
AACGGGCGGTTCGCCTCGCACAAT -> ACGGGCGGTTCGCCTCGCACAATT
TCAGTAATGATGGTTCACTCTTTG -> CAGTAATGATGGTTCACTCTTTGC
TAGAACGAAAACGGAGAGGGGTTG -> AGAACGAAAACGGAGAGGGGTTGG
GTTACAACGGATACCGCCTTGCAT -> TTACAACGGATACCGCCTTGCATT
CTAATGTACGCAGGACGAAATCTA -> TAATGTACGCAGGACGAAATCTAT
CACCAACAATTTCCCCACTTTCTT -> ACCAACAATTTCCCCACTTTCTTT
GGACAGGGCCGTCGCCGATATCAT -> GACAGGGCCGTCGCCGATATCATC
ACCCTAGCATTTGCGGTTAGATAC -> CCCTAGCATTTGCGGTTAGATACA
ATGTGCGGGTGGCTAAGCTTCGAA -> TGTGCGGGTGGCTAAGCTTCGAAA
TATAACATGATTCGAGGGATGCTG -> ATAACATGATTCGAGGGATGCTGG
ACTCTTTGCCAGACTTGGTAGGCG -> CTCTTTGCCAGACTTGGTAGGCGT
GCTTCCCTAGACCCGCACAACTAG -> CTTCCCTAGACCCGCACAACTAGG
AGACGGGTCAGTATAACATGATTC -> GACGGGTCAGTATAACATGATTCG
CTTGTTGGAAACGGGGAAACCGGC -> TTGTTGGAAACGGGGAAACCGGCC
GGATACCGCCTTGCATTCGTGTCG -> GATACCGCCTTGCATTCGTGTCGT
ATTTCGTGCACGTACAGTGAGGAA -> TTTCGTGCACGTACAGTGAGGAAC
ATTAGGCATCTCCGGACGACCACT -> TTAGGCATCTCCGGACGACCACTT
ACCAGTGCAATGAGCCTTTAAGCA -> CCAGTGCAATGAGCCTTTAAGCAA
CGCATTGGTGTCTGATGTTAATGA -> GCATTGGTGTCTGATGTTAATGAG
GCTTCCTTGATGCACCTAAATAGT -> CTTCCTTGATGCACCTAAATAGTG
CATTGCCGAGGGCTAACTTGTTTT -> ATTGCCGAGGGCTAACTTGTTTTG
CATAGGGAGTTACGGACCTACAGA -> ATAGGGAGTTACGGACCTACAGAC
CCAAGGAAAATCTGATTCGCGCGG -> CAAGGAAAATCTGATTCGCGCGGT
ATTTGGCTTCCTTGATGCACCTAA -> TTTGGCTTCCTTGATGCACCTAAA
ATAGGTACAAAACATCCTCCCTTT -> TAGGTACAAAACATCCTCCCTTTC
ATATAGGATGTTGGCTCACGTACA -> TATAGGATGTTGGCTCACGTACAC
GAGACGCCGGGATGGCCAGTGGCC -> AGACGCCGGGATGGCCAGTGGCCC
TCGGCAAGCAACGTTATATTATCT -> CGGCAAGCAACGTTATATTATCTT
TGCTAGCGGCTTAAGTTAGGGTTA -> GCTAGCGGCTTAAGTTAGGGTTAG
GTGTCTGATGTTAATGAGTGAAAT -> TGTCTGATGTTAATGAGTGAAATT
ATGGTTCACTCTTTGCCAGACTTG -> TGGTTCACTCTTTGCCAGACTTGG
GAGTAACGGAACAAGCAGGAAAAA -> AGTAACGGAACAAGCAGGAAAAAT
TACAAAACATCCTCCCTTTCCATA -> ACAAAACATCCTCCCTTTCCATAG
TGAGTTGTAGGCGCTGCATTAACG -> GAGTTGTAGGCGCTGCATTAACGA
GGTCTCACTAACTGAGACGTTCTC -> GTCTCACTAACTGAGACGTTCTCA
GAACGTTCCTGGTCGTAACGGGCG -> AACGTTCCTGGTCGTAACGGGCGG
CGTCGTGAATATTTCCTCTGGCGA -> GTCGTGAATATTTCCTCTGGCGAT
AGTTCGCCGTTCTGCTGGTATTGG -> GTTCGCCGTTCTGCTGGTATTGGG
AGGAAAATCTGATTCGCGCGGTTT -> GGAAAATCTGATTCGCGCGGTTTC
GAGGGATGCTGGACGTAGGGCGGA -> AGGGATGCTGGACGTAGGGCGGAC
TGCGGGATGGGCACACCGCCTATG -> GCGGGATGGGCACACCGCCTATGG
TTTGATTGCCGATTCACGCAGCAT -> TTGATTGCCGATTCACGCAGCATC
GGCTGAGGTAGGAAGCCTCGAAAT -> GCTGAGGTAGGAAGCCTCGAAATT
CCTAGCATTTGCGGTTAGATACAC -> CTAGCATTTGCGGTTAGATACACA
CTAGCCGTAGAAATAAATGATGGA -> TAGCCGTAGAAATAAATGATGGAC
ATTTTAGGAATGGTACCTTCATAC -> TTTTAGGAATGGTACCTTCATACG
TCGACATTATAGGCTCTCCAGCCC -> CGACATTATAGGCTCTCCAGCCCG
TCGTAACGGGCGGTTCGCCTCGCA -> CGTAACGGGCGGTTCGCCTCGCAC
AGACGTTGTGAATTAGGCATCTCC -> GACGTTGTGAATTAGGCATCTCCG
ACCATCCGCCCAAATGTAGAACGA -> CCATCCGCCCAAATGTAGAACGAA
ATGCTGGACGTAGGGCGGACGTGT -> TGCTGGACGTAGGGCGGACGTGTC
CAAAGGCACGTCGTGAATATTTCC -> AAAGGCACGTCGTGAATATTTCCT
TTTCCCCACTTTCTTTTCATGGGG -> TTCCCCACTTTCTTTTCATGGGGT
CGTAAACTGCCCAGACTTAAAACC -> GTAAACTGCCCAGACTTAAAACCA
CTCGAGCTATGCGTATAAGCGCGA -> TCGAGCTATGCGTATAAGCGCGAA
TGTCTGATGTTAATGAGTGAAATT -> GTCTGATGTTAATGAGTGAAATTC
ACTAAGGATGTCAAAACGCCAATG -> CTAAGGATGTCAAAACGCCAATGC
GTATTCACCGACTAAGGATGTCAA -> TATTCACCGACTAAGGATGTCAAA
CCGAGGGCTAACTTGTTTTGAATT -> CGAGGGCTAACTTGTTTTGAATTG
TCGAGCTATGCGTATAAGCGCGAA -> CGAGCTATGCGTATAAGCGCGAAT
AGTTGTAGGCGCTGCATTAACGAC -> GTTGTAGGCGCTGCATTAACGACG
CTTCATACGATTTAATAGCGTAAA -> TTCATACGATTTAATAGCGTAAAG
TTGCCAGACTTGGTAGGCGTGTCA -> TGCCAGACTTGGTAGGCGTGTCAT
TGCGTGGTGCTTCAAACGTCTTAC -> GCGTGGTGCTTCAAACGTCTTACT
CGATATATCGTGCCTCACTAGAAC -> GATATATCGTGCCTCACTAGAACT
CTTTTCATGGGGTCATTGCCGAGG -> TTTTCATGGGGTCATTGCCGAGGG
TCAGACGTTGTGAATTAGGCATCT -> CAGACGTTGTGAATTAGGCATCTC
CTGCTGGTATTGGGCTTATACCAC -> TGCTGGTATTGGGCTTATACCACG
TTGGCTTCCTTGATGCACCTAAAT -> TGGCTTCCTTGATGCACCTAAATA
TAACTGAGACGTTCTCAAAGGCAC -> AACTGAGACGTTCTCAAAGGCACG
TAATAGCGTAAAGACTTCACAAGG -> AATAGCGTAAAGACTTCACAAGGT
TGTCTAGCCGTAGAAATAAATGAT -> GTCTAGCCGTAGAAATAAATGATG
TGTGCGTGGTGCTTCAAACGTCTT -> GTGCGTGGTGCTTCAAACGTCTTA
CATAGAAGTTGGGTATCAGGCGCA -> ATAGAAGTTGGGTATCAGGCGCAC
CGCGCATTGAGTCTTCGAGCACTG -> GCGCATTGAGTCTTCGAGCACTGT
CACGGCGTGCCCGCGAGAAGCAAT -> ACGGCGTGCCCGCGAGAAGCAATA
GGAAAGCATTTGGCTTCCTTGATG -> GAAAGCATTTGGCTTCCTTGATGC
GAAACCAGCGCATCGGCAAGCAAC -> AAACCAGCGCATCGGCAAGCAACG
CCTGTTCTACCCTAGCATTTGCGG -> CTGTTCTACCCTAGCATTTGCGGT
TTCGAAAGTTGGCGTATATCATAA -> TCGAAAGTTGGCGTATATCATAAT
GGAGAGAGGCAACAACCGCTCGTC -> GAGAGAGGCAACAACCGCTCGTCT
ACAGACGGGTCAGTATAACATGAT -> CAGACGGGTCAGTATAACATGATT
GCTCACGTACACTGAGTTGTAGGC -> CTCACGTACACTGAGTTGTAGGCG
GAGGGGTTGGAACGTTCCTGGTCG -> AGGGGTTGGAACGTTCCTGGTCGT
GGCGCTGCATTAACGACGATATAT -> GCGCTGCATTAACGACGATATATC
GAAAGCATTTGGCTTCCTTGATGC -> AAAGCATTTGGCTTCCTTGATGCA
GATTGCCGATTCACGCAGCATCTC -> ATTGCCGATTCACGCAGCATCTCG
TGACTCGTCCAAGGAAAATCTGAT -> GACTCGTCCAAGGAAAATCTGATT
TCGCTTCCAAAGGCAGAAATAGAA -> CGCTTCCAAAGGCAGAAATAGAAC
CTAAGGATGTCAAAACGCCAATGC -> TAAGGATGTCAAAACGCCAATGCA
TCATCAAGTGGTGAAACGTTTTTA -> CATCAAGTGGTGAAACGTTTTTAT
GGAAGCCTCGAAATTTTAGGAATG -> GAAGCCTCGAAATTTTAGGAATGG
GCATCATTCCTGTGCTAGCGGCTT -> CATCATTCCTGTGCTAGCGGCTTA
CCAGTGGCCCTAGCCCAATTGTTC -> CAGTGGCCCTAGCCCAATTGTTCG
AACTGAGACGTTCTCAAAGGCACG -> ACTGAGACGTTCTCAAAGGCACGT
TAGACCCGCACAACTAGGGCGAGT -> AGACCCGCACAACTAGGGCGAGTA
AATTAGAACGTTGGTGAGTCATTC -> ATTAGAACGTTGGTGAGTCATTCA
TATATCGTGCCTCACTAGAACTAT -> ATATCGTGCCTCACTAGAACTATG
ACTACGGCAGCTTCCCTAGACCCG -> CTACGGCAGCTTCCCTAGACCCGC
TGGCGTATATCATAATACTGCGTT -> GGCGTATATCATAATACTGCGTTG
TATATTATCTTGATAGGGCACAGC -> ATATTATCTTGATAGGGCACAGCA
AGCCTACTAATGTACGCAGGACGA -> GCCTACTAATGTACGCAGGACGAA
CGTAGAAATAAATGATGGACGTCA -> GTAGAAATAAATGATGGACGTCAT
ATGTTAATGAGTGAAATTCTCAGA -> TGTTAATGAGTGAAATTCTCAGAC
AAATCTGATTCGCGCGGTTTCTAA -> AATCTGATTCGCGCGGTTTCTAAC
ACACCGCCTCCCTCGACAACTAAC -> CACCGCCTCCCTCGACAACTAACT
CCGTAGAAATAAATGATGGACGTC -> CGTAGAAATAAATGATGGACGTCA
ATCACTATGTTTGAGCGACGCATT -> TCACTATGTTTGAGCGACGCATTG
ACGAAATCTATATTAATAGTCCAC -> CGAAATCTATATTAATAGTCCACT
TCGCCATAGAAGTTGGGTATCAGG -> CGCCATAGAAGTTGGGTATCAGGC
TAGGAAGCCTCGAAATTTTAGGAA -> AGGAAGCCTCGAAATTTTAGGAAT
TACACTGAGTTGTAGGCGCTGCAT -> ACACTGAGTTGTAGGCGCTGCATT
AATAGTGCGTGAGATTTCGTGCAC -> ATAGTGCGTGAGATTTCGTGCACG
TGAGTCATTCATAGGTACAAAACA -> GAGTCATTCATAGGTACAAAACAT
TCTTTTCATGGGGTCATTGCCGAG -> CTTTTCATGGGGTCATTGCCGAGG
TGGTACCTTCATACGATTTAATAG -> GGTACCTTCATACGATTTAATAGC
TGCATTAACGACGATATATCGTGC -> GCATTAACGACGATATATCGTGCC
CAACAACCGCTCGTCTTAAGAAAC -> AACAACCGCTCGTCTTAAGAAACC
TTTCCATAGTTCTGGAAGGAGTGT -> TTCCATAGTTCTGGAAGGAGTGTT
CCGAAGGGAGCACCAACAATTTCC -> CGAAGGGAGCACCAACAATTTCCC
GATAGAGTATTCACCGACTAAGGA -> ATAGAGTATTCACCGACTAAGGAT
TATACCAGTGCAATGAGCCTTTAA -> ATACCAGTGCAATGAGCCTTTAAG
TATTGGGTGACCACGGACGTGTAT -> ATTGGGTGACCACGGACGTGTATG
CGAAATTTTAGGAATGGTACCTTC -> GAAATTTTAGGAATGGTACCTTCA
TTCGCGCGGTTTCTAACAGGTCTC -> TCGCGCGGTTTCTAACAGGTCTCA
GTTGGAACGTTCCTGGTCGTAACG -> TTGGAACGTTCCTGGTCGTAACGG
GAAGCAATAATTAGAACGTTGGTG -> AAGCAATAATTAGAACGTTGGTGA
CAGACGGGTCAGTATAACATGATT -> AGACGGGTCAGTATAACATGATTC
CTTTCTTTTCATGGGGTCATTGCC -> TTTCTTTTCATGGGGTCATTGCCG
GCCTATGGAAAGCATTTGGCTTCC -> CCTATGGAAAGCATTTGGCTTCCT
CGATTCACGCAGCATCTCGAGCTA -> GATTCACGCAGCATCTCGAGCTAT
GATACACATAGGGAGTTACGGACC -> ATACACATAGGGAGTTACGGACCT
ATGATTCGAGGGATGCTGGACGTA -> TGATTCGAGGGATGCTGGACGTAG
CGACTAAGGATGTCAAAACGCCAA -> GACTAAGGATGTCAAAACGCCAAT
GTAATGATGGTTCACTCTTTGCCA -> TAATGATGGTTCACTCTTTGCCAG
TAGCGGCTTAAGTTAGGGTTAGAT -> AGCGGCTTAAGTTAGGGTTAGATT
GGTGGGCACATCGCCATAGAAGTT -> GTGGGCACATCGCCATAGAAGTTG
AGTGAGGAACAATCGGGCGTCCCC -> GTGAGGAACAATCGGGCGTCCCCA
TTCGTGCACGTACAGTGAGGAACA -> TCGTGCACGTACAGTGAGGAACAA
GCATTTGGCTTCCTTGATGCACCT -> CATTTGGCTTCCTTGATGCACCTA
TGAATTGCATATCACTATGTTTGA -> GAATTGCATATCACTATGTTTGAG
CCAGACTTGGTAGGCGTGTCATAC -> CAGACTTGGTAGGCGTGTCATACA
ACGTGTATGACTCTGTTTGATTGC -> CGTGTATGACTCTGTTTGATTGCC
AGCACTGTTACAACGGATACCGCC -> GCACTGTTACAACGGATACCGCCT
GGCGCACAGTGAAAAGCTCCTTTT -> GCGCACAGTGAAAAGCTCCTTTTA
TAGACTCGTGACTAGGTATCAGAA -> AGACTCGTGACTAGGTATCAGAAA
GCGAGAAGCAATAATTAGAACGTT -> CGAGAAGCAATAATTAGAACGTTG
TTGGTAGGCGTGTCATACAAGTCT -> TGGTAGGCGTGTCATACAAGTCTT
TACCAGTGCAATGAGCCTTTAAGC -> ACCAGTGCAATGAGCCTTTAAGCA
TTGTTCGACATTATAGGCTCTCCA -> TGTTCGACATTATAGGCTCTCCAG
TCTGTTTGATTGCCGATTCACGCA -> CTGTTTGATTGCCGATTCACGCAG
TCTCACTAACTGAGACGTTCTCAA -> CTCACTAACTGAGACGTTCTCAAA
TTGAGTCTTCGAGCACTGTTACAA -> TGAGTCTTCGAGCACTGTTACAAC
TTTGGCTTCCTTGATGCACCTAAA -> TTGGCTTCCTTGATGCACCTAAAT
CGCATCGGCAAGCAACGTTATATT -> GCATCGGCAAGCAACGTTATATTA
GAGGAACAATCGGGCGTCCCCATT -> AGGAACAATCGGGCGTCCCCATTA
CTCACTAACTGAGACGTTCTCAAA -> TCACTAACTGAGACGTTCTCAAAG
ACATTATAGGCTCTCCAGCCCGGC -> CATTATAGGCTCTCCAGCCCGGCA
CCATCCGCCCAAATGTAGAACGAA -> CATCCGCCCAAATGTAGAACGAAA
GTGCACGTACAGTGAGGAACAATC -> TGCACGTACAGTGAGGAACAATCG
ACGTTCTCAAAGGCACGTCGTGAA -> CGTTCTCAAAGGCACGTCGTGAAT
GAAACGGGGAAACCGGCCGACGGG -> AAACGGGGAAACCGGCCGACGGGT
TCTCCGGACGACCACTTGAGTCGA -> CTCCGGACGACCACTTGAGTCGAC
TATGATCTCGCATCATTCCTGTGC -> ATGATCTCGCATCATTCCTGTGCT
ACTTCGAAGTTCGCCGTTCTGCTG -> CTTCGAAGTTCGCCGTTCTGCTGG
AGTGTATGGAAATATAGGATGTTG -> GTGTATGGAAATATAGGATGTTGG
TTAAAGGAGAGAGGCAACAACCGC -> TAAAGGAGAGAGGCAACAACCGCT
CTGTTTGATTGCCGATTCACGCAG -> TGTTTGATTGCCGATTCACGCAGC
CGGGATGGCCAGTGGCCCTAGCCC -> GGGATGGCCAGTGGCCCTAGCCCA
TTCTGGAAGGAGTGTTTAAAGGAG -> TCTGGAAGGAGTGTTTAAAGGAGA
CCTCTGGCGATTACACTATACCAG -> CTCTGGCGATTACACTATACCAGT
TACAGTGAGGAACAATCGGGCGTC -> ACAGTGAGGAACAATCGGGCGTCC
TCGACACATCAAGCCTACTAATGT -> CGACACATCAAGCCTACTAATGTA
GCAACAACCGCTCGTCTTAAGAAA -> CAACAACCGCTCGTCTTAAGAAAC
CTTTTATATGTGAAGTAGAGTCTG -> TTTTATATGTGAAGTAGAGTCTGG
GGACCCGAAGGGAGCACCAACAAT -> GACCCGAAGGGAGCACCAACAATT
GCGTATAAGCGCGAATGATTTGCT -> CGTATAAGCGCGAATGATTTGCTA
CACTGCGCCTTGTTGGAAACGGGG -> ACTGCGCCTTGTTGGAAACGGGGA
GTGAAATTCTCAGACGTTGTGAAT -> TGAAATTCTCAGACGTTGTGAATT
GTTCTGCTGGTATTGGGCTTATAC -> TTCTGCTGGTATTGGGCTTATACC
GGAGCACCAACAATTTCCCCACTT -> GAGCACCAACAATTTCCCCACTTT
GGCACAGCAGGACCCGAAGGGAGC -> GCACAGCAGGACCCGAAGGGAGCA
TGAAATTCTCAGACGTTGTGAATT -> GAAATTCTCAGACGTTGTGAATTA
GAATATTTCCTCTGGCGATTACAC -> AATATTTCCTCTGGCGATTACACT
AAATATATCACACTTATTGGGTGA -> AATATATCACACTTATTGGGTGAC
GCGAGTCGGCTGAGGTAGGAAGCC -> CGAGTCGGCTGAGGTAGGAAGCCT
CATTGAGTCTTCGAGCACTGTTAC -> ATTGAGTCTTCGAGCACTGTTACA
GCTTCCAAAGGCAGAAATAGAACC -> CTTCCAAAGGCAGAAATAGAACCG
ACATCCTCCCTTTCCATAGTTCTG -> CATCCTCCCTTTCCATAGTTCTGG
GTGTCTAGCCGTAGAAATAAATGA -> TGTCTAGCCGTAGAAATAAATGAT
CTCCATCCCCATCAAATATATCAC -> TCCATCCCCATCAAATATATCACA
GCACTGTTACAACGGATACCGCCT -> CACTGTTACAACGGATACCGCCTT
AATTGCATATCACTATGTTTGAGC -> ATTGCATATCACTATGTTTGAGCG
GTGTATGGAAATATAGGATGTTGG -> TGTATGGAAATATAGGATGTTGGC
TCACTAGAACTATGACTGACTCGT -> CACTAGAACTATGACTGACTCGTC
AGTCCACTGCGCCTTGTTGGAAAC -> GTCCACTGCGCCTTGTTGGAAACG
CCTTCATACGATTTAATAGCGTAA -> CTTCATACGATTTAATAGCGTAAA
CCTCCCTCGACAACTAACTCGACC -> CTCCCTCGACAACTAACTCGACCA
ATAGGCTCTCCAGCCCGGCAATAA -> TAGGCTCTCCAGCCCGGCAATAAT
TTTCGTGCACGTACAGTGAGGAAC -> TTCGTGCACGTACAGTGAGGAACA
AACGGAGAGGGGTTGGAACGTTCC -> ACGGAGAGGGGTTGGAACGTTCCT
TGGTAGGCGTGTCATACAAGTCTT -> GGTAGGCGTGTCATACAAGTCTTG
ATAGAAGTTGGGTATCAGGCGCAC -> TAGAAGTTGGGTATCAGGCGCACA
TGATTCGCGCGGTTTCTAACAGGT -> GATTCGCGCGGTTTCTAACAGGTC
AGTGGTGAAACGTTTTTATGATCT -> GTGGTGAAACGTTTTTATGATCTC
ACAAGCAGGAAAAATCAGTAATGA -> CAAGCAGGAAAAATCAGTAATGAT
AGTGAAATTCTCAGACGTTGTGAA -> GTGAAATTCTCAGACGTTGTGAAT
GAAAAGCTCCTTTTATATGTGAAG -> AAAAGCTCCTTTTATATGTGAAGT
CTGGACGTAGGGCGGACGTGTCTA -> TGGACGTAGGGCGGACGTGTCTAG
GGTTCGCCTCGCACAATTCACTCT -> GTTCGCCTCGCACAATTCACTCTG
AATCGCTTCCAAAGGCAGAAATAG -> ATCGCTTCCAAAGGCAGAAATAGA
CTGACATGTGCGGGTGGCTAAGCT -> TGACATGTGCGGGTGGCTAAGCTT
CACGTCGTGAATATTTCCTCTGGC -> ACGTCGTGAATATTTCCTCTGGCG
CGCATTGAGTCTTCGAGCACTGTT -> GCATTGAGTCTTCGAGCACTGTTA
TATTGGCCATTAATCGCTTCCAAA -> ATTGGCCATTAATCGCTTCCAAAG
CAGTGAGGAACAATCGGGCGTCCC -> AGTGAGGAACAATCGGGCGTCCCC
TTCTCAAAGGCACGTCGTGAATAT -> TCTCAAAGGCACGTCGTGAATATT
AGAGAGGCAACAACCGCTCGTCTT -> GAGAGGCAACAACCGCTCGTCTTA
ATAGGGCACAGCAGGACCCGAAGG -> TAGGGCACAGCAGGACCCGAAGGG
GGGTATCAGGCGCACAGTGAAAAG -> GGTATCAGGCGCACAGTGAAAAGC
TCCTGTGCTAGCGGCTTAAGTTAG -> CCTGTGCTAGCGGCTTAAGTTAGG
TTTACTTGCTCCATCCCCATCAAA -> TTACTTGCTCCATCCCCATCAAAT
GAAATTCAGGCTGCTTCCAGCAGC -> AAATTCAGGCTGCTTCCAGCAGCT
TCGCGCGGTTTCTAACAGGTCTCA -> CGCGCGGTTTCTAACAGGTCTCAC
ATGATGGACGTCATAGTCCGGTGG -> TGATGGACGTCATAGTCCGGTGGG
TAACGGAACAAGCAGGAAAAATCA -> AACGGAACAAGCAGGAAAAATCAG
CACGTACAGTGAGGAACAATCGGG -> ACGTACAGTGAGGAACAATCGGGC
GGATGTTGGCTCACGTACACTGAG -> GATGTTGGCTCACGTACACTGAGT
TTCGCCGTTCTGCTGGTATTGGGC -> TCGCCGTTCTGCTGGTATTGGGCT
GGACGTGTCTAGCCGTAGAAATAA -> GACGTGTCTAGCCGTAGAAATAAA
CTCTGACATGTGCGGGTGGCTAAG -> TCTGACATGTGCGGGTGGCTAAGC
TAGCCCAATTGTTCGACATTATAG -> AGCCCAATTGTTCGACATTATAGG
CCCTAGACCCGCACAACTAGGGCG -> CCTAGACCCGCACAACTAGGGCGA
CGTTGCGAGTCGGCTGAGGTAGGA -> GTTGCGAGTCGGCTGAGGTAGGAA
AAGCTCCTTTTATATGTGAAGTAG -> AGCTCCTTTTATATGTGAAGTAGA
TTGGCTCACGTACACTGAGTTGTA -> TGGCTCACGTACACTGAGTTGTAG
TGATAGGGCACAGCAGGACCCGAA -> GATAGGGCACAGCAGGACCCGAAG
CGGGGAAACCGGCCGACGGGTAGG -> GGGGAAACCGGCCGACGGGTAGGA
CTTCAAACGTCTTACTTCGAAGTT -> TTCAAACGTCTTACTTCGAAGTTC
ATGACTACGGCAGCTTCCCTAGAC -> TGACTACGGCAGCTTCCCTAGACC
GCAAGGAAACAGGGACAGGGCCGT -> CAAGGAAACAGGGACAGGGCCGTC
GGTGAAACGTTTTTATGATCTCGC -> GTGAAACGTTTTTATGATCTCGCA
CTATACCAGTGCAATGAGCCTTTA -> TATACCAGTGCAATGAGCCTTTAA
GTAGGCGTGTCATACAAGTCTTGC -> TAGGCGTGTCATACAAGTCTTGCG
GATGGACGTCATAGTCCGGTGGGC -> ATGGACGTCATAGTCCGGTGGGCA
AACGGATACCGCCTTGCATTCGTG -> ACGGATACCGCCTTGCATTCGTGT
CGACCATCCGCCCAAATGTAGAAC -> GACCATCCGCCCAAATGTAGAACG
ATGGACGTCATAGTCCGGTGGGCA -> TGGACGTCATAGTCCGGTGGGCAC
CCATTCGCGCATTGAGTCTTCGAG -> CATTCGCGCATTGAGTCTTCGAGC
CATCAAATATATCACACTTATTGG -> ATCAAATATATCACACTTATTGGG
AGAAATAAATGATGGACGTCATAG -> GAAATAAATGATGGACGTCATAGT
AAAAATCAGTAATGATGGTTCACT -> AAAATCAGTAATGATGGTTCACTC
TCCCTAGACTCGTGACTAGGTATC -> CCCTAGACTCGTGACTAGGTATCA
CTGGTACCATTCGCGCATTGAGTC -> TGGTACCATTCGCGCATTGAGTCT
AGCTCCTTTTATATGTGAAGTAGA -> GCTCCTTTTATATGTGAAGTAGAG
ATTCGCGCGGTTTCTAACAGGTCT -> TTCGCGCGGTTTCTAACAGGTCTC
TTTGCGGTTAGATACACATAGGGA -> TTGCGGTTAGATACACATAGGGAG
ATTTCCTCTGGCGATTACACTATA -> TTTCCTCTGGCGATTACACTATAC
AACCTGTTCTACCCTAGCATTTGC -> ACCTGTTCTACCCTAGCATTTGCG
ACTGCGCCTTGTTGGAAACGGGGA -> CTGCGCCTTGTTGGAAACGGGGAA
TATGACTGACTCGTCCAAGGAAAA -> ATGACTGACTCGTCCAAGGAAAAT
CTGGGATAGAGTATTCACCGACTA -> TGGGATAGAGTATTCACCGACTAA
TTCGCGCATTGAGTCTTCGAGCAC -> TCGCGCATTGAGTCTTCGAGCACT
CGTTATATTATCTTGATAGGGCAC -> GTTATATTATCTTGATAGGGCACA
ACAGTGAAAAGCTCCTTTTATATG -> CAGTGAAAAGCTCCTTTTATATGT
AAACCGGCCGACGGGTAGGACTCG -> AACCGGCCGACGGGTAGGACTCGG
CGGCCGACGGGTAGGACTCGGCCT -> GGCCGACGGGTAGGACTCGGCCTT
ATTACACTATACCAGTGCAATGAG -> TTACACTATACCAGTGCAATGAGC
CCAAAGGCAGAAATAGAACCGAAT -> CAAAGGCAGAAATAGAACCGAATC
CATACAAGTCTTGCGTGACACCGC -> ATACAAGTCTTGCGTGACACCGCC
GGGCCGTCGCCGATATCATCAAGT -> GGCCGTCGCCGATATCATCAAGTG
CATCATTCCTGTGCTAGCGGCTTA -> ATCATTCCTGTGCTAGCGGCTTAA
AGAGTATTCACCGACTAAGGATGT -> GAGTATTCACCGACTAAGGATGTC
CCACTTGAGTCGACACATCAAGCC -> CACTTGAGTCGACACATCAAGCCT
TGGTATTGGGCTTATACCACGGCG -> GGTATTGGGCTTATACCACGGCGT
AAGGAAAATCTGATTCGCGCGGTT -> AGGAAAATCTGATTCGCGCGGTTT
TCTTTGCCAGACTTGGTAGGCGTG -> CTTTGCCAGACTTGGTAGGCGTGT
GCCTTGCATTCGTGTCGTGGCCAA -> CCTTGCATTCGTGTCGTGGCCAAC
GGCAGCTTCCCTAGACCCGCACAA -> GCAGCTTCCCTAGACCCGCACAAC
TGTGCTAGCGGCTTAAGTTAGGGT -> GTGCTAGCGGCTTAAGTTAGGGTT
GCTTAAGTTAGGGTTAGATTAATG -> CTTAAGTTAGGGTTAGATTAATGG
ACCGCCTTGCATTCGTGTCGTGGC -> CCGCCTTGCATTCGTGTCGTGGCC
GCCCTAGCCCAATTGTTCGACATT -> CCCTAGCCCAATTGTTCGACATTA
ACCACGGCGTGCCCGCGAGAAGCA -> CCACGGCGTGCCCGCGAGAAGCAA
CGCCTATGGAAAGCATTTGGCTTC -> GCCTATGGAAAGCATTTGGCTTCC
ATGGTACCTTCATACGATTTAATA -> TGGTACCTTCATACGATTTAATAG
CCACGGACGTGTATGACTCTGTTT -> CACGGACGTGTATGACTCTGTTTG
TTGCCGAGGGCTAACTTGTTTTGA -> TGCCGAGGGCTAACTTGTTTTGAA
TCTGATTCGCGCGGTTTCTAACAG -> CTGATTCGCGCGGTTTCTAACAGG
CTTCGAAAGTTGGCGTATATCATA -> TTCGAAAGTTGGCGTATATCATAA
GCGTGACACCGCCTCCCTCGACAA -> CGTGACACCGCCTCCCTCGACAAC
GGGCACACCGCCTATGGAAAGCAT -> GGCACACCGCCTATGGAAAGCATT
GTCTAGCCGTAGAAATAAATGATG -> TCTAGCCGTAGAAATAAATGATGG
TGACTCTGTTTGATTGCCGATTCA -> GACTCTGTTTGATTGCCGATTCAC
ATAATTAGAACGTTGGTGAGTCAT -> TAATTAGAACGTTGGTGAGTCATT
TCAGGCTGCTTCCAGCAGCTACAT -> CAGGCTGCTTCCAGCAGCTACATG
GATTTCGTGCACGTACAGTGAGGA -> ATTTCGTGCACGTACAGTGAGGAA
CACCGACTAAGGATGTCAAAACGC -> ACCGACTAAGGATGTCAAAACGCC
AGCAGGACCCGAAGGGAGCACCAA -> GCAGGACCCGAAGGGAGCACCAAC
GGTGAGTCATTCATAGGTACAAAA -> GTGAGTCATTCATAGGTACAAAAC
CATTAGTGTATGGAAATATAGGAT -> ATTAGTGTATGGAAATATAGGATG
GAGGGCTAACTTGTTTTGAATTGC -> AGGGCTAACTTGTTTTGAATTGCA
AATTGTTCGACATTATAGGCTCTC -> ATTGTTCGACATTATAGGCTCTCC
CGAGTCGGCTGAGGTAGGAAGCCT -> GAGTCGGCTGAGGTAGGAAGCCTC
CGAGCTATGCGTATAAGCGCGAAT -> GAGCTATGCGTATAAGCGCGAATG
ATTGGGTGACCACGGACGTGTATG -> TTGGGTGACCACGGACGTGTATGA
GCGGTTCGCCTCGCACAATTCACT -> CGGTTCGCCTCGCACAATTCACTC
ACGATTTAATAGCGTAAAGACTTC -> CGATTTAATAGCGTAAAGACTTCA
AACGTTGGTGAGTCATTCATAGGT -> ACGTTGGTGAGTCATTCATAGGTA
GGCTAAGCTTCGAAAGTTGGCGTA -> GCTAAGCTTCGAAAGTTGGCGTAT
CACGGACGTGTATGACTCTGTTTG -> ACGGACGTGTATGACTCTGTTTGA
CGGCGTGCCCGCGAGAAGCAATAA -> GGCGTGCCCGCGAGAAGCAATAAT
TCCCTCGACAACTAACTCGACCAT -> CCCTCGACAACTAACTCGACCATC
ATCGCTTCCAAAGGCAGAAATAGA -> TCGCTTCCAAAGGCAGAAATAGAA
ATTGCCGATTCACGCAGCATCTCG -> TTGCCGATTCACGCAGCATCTCGA
GTTGTGAATTAGGCATCTCCGGAC -> TTGTGAATTAGGCATCTCCGGACG
GCAATGAGCCTTTAAGCAATTTAC -> CAATGAGCCTTTAAGCAATTTACT
CTGCGCCTTGTTGGAAACGGGGAA -> TGCGCCTTGTTGGAAACGGGGAAA
TTATAGGCTCTCCAGCCCGGCAAT -> TATAGGCTCTCCAGCCCGGCAATA
AGAAGCAATAATTAGAACGTTGGT -> GAAGCAATAATTAGAACGTTGGTG
CTTCCAAAGGCAGAAATAGAACCG -> TTCCAAAGGCAGAAATAGAACCGA
ACAGCAGGACCCGAAGGGAGCACC -> CAGCAGGACCCGAAGGGAGCACCA
AAATATAGGATGTTGGCTCACGTA -> AATATAGGATGTTGGCTCACGTAC
CAAATATATCACACTTATTGGGTG -> AAATATATCACACTTATTGGGTGA
CAAAACATCCTCCCTTTCCATAGT -> AAAACATCCTCCCTTTCCATAGTT
CGGGATGGGCACACCGCCTATGGA -> GGGATGGGCACACCGCCTATGGAA
TTTAGGAATGGTACCTTCATACGA -> TTAGGAATGGTACCTTCATACGAT
GAGTGTTTAAAGGAGAGAGGCAAC -> AGTGTTTAAAGGAGAGAGGCAACA
GCAGCTTCCCTAGACCCGCACAAC -> CAGCTTCCCTAGACCCGCACAACT
AACTCGACCATCCGCCCAAATGTA -> ACTCGACCATCCGCCCAAATGTAG
TGATGTTAATGAGTGAAATTCTCA -> GATGTTAATGAGTGAAATTCTCAG
TTGCTCCATCCCCATCAAATATAT -> TGCTCCATCCCCATCAAATATATC
CGTATAAGCGCGAATGATTTGCTA -> GTATAAGCGCGAATGATTTGCTAT
GGATGCTGGACGTAGGGCGGACGT -> GATGCTGGACGTAGGGCGGACGTG
ATCCGCCCAAATGTAGAACGAAAA -> TCCGCCCAAATGTAGAACGAAAAC
TTGCATATCACTATGTTTGAGCGA -> TGCATATCACTATGTTTGAGCGAC
TTCCTGGTCGTAACGGGCGGTTCG -> TCCTGGTCGTAACGGGCGGTTCGC
TACGATTTAATAGCGTAAAGACTT -> ACGATTTAATAGCGTAAAGACTTC
CCAACAATTTCCCCACTTTCTTTT -> CAACAATTTCCCCACTTTCTTTTC
GGTTAGATACACATAGGGAGTTAC -> GTTAGATACACATAGGGAGTTACG
CGCAGGACGAAATCTATATTAATA -> GCAGGACGAAATCTATATTAATAG
ACTAACTGAGACGTTCTCAAAGGC -> CTAACTGAGACGTTCTCAAAGGCA
GTACAAAACATCCTCCCTTTCCAT -> TACAAAACATCCTCCCTTTCCATA
GAATTGCATATCACTATGTTTGAG -> AATTGCATATCACTATGTTTGAGC
ACATCGCCATAGAAGTTGGGTATC -> CATCGCCATAGAAGTTGGGTATCA
AACAATTTCCCCACTTTCTTTTCA -> ACAATTTCCCCACTTTCTTTTCAT
ACCATTCGCGCATTGAGTCTTCGA -> CCATTCGCGCATTGAGTCTTCGAG
GCGCCTTGTTGGAAACGGGGAAAC -> CGCCTTGTTGGAAACGGGGAAACC
TATTATCTTGATAGGGCACAGCAG -> ATTATCTTGATAGGGCACAGCAGG
CAGCAGGACCCGAAGGGAGCACCA -> AGCAGGACCCGAAGGGAGCACCAA
CTTGTTTTGAATTGCATATCACTA -> TTGTTTTGAATTGCATATCACTAT
CAGGCTGCTTCCAGCAGCTACATG -> AGGCTGCTTCCAGCAGCTACATGA
CTATTGGCCATTAATCGCTTCCAA -> TATTGGCCATTAATCGCTTCCAAA
TTGGGCTTATACCACGGCGTGCCC -> TGGGCTTATACCACGGCGTGCCCG
ATTGGTGTCTGATGTTAATGAGTG -> TTGGTGTCTGATGTTAATGAGTGA
AGGGAGTTACGGACCTACAGACGG -> GGGAGTTACGGACCTACAGACGGG
CATATCACTATGTTTGAGCGACGC -> ATATCACTATGTTTGAGCGACGCA
GTGCGTGGTGCTTCAAACGTCTTA -> TGCGTGGTGCTTCAAACGTCTTAC
ACGGGTCAGTATAACATGATTCGA -> CGGGTCAGTATAACATGATTCGAG
GGAAAATCTGATTCGCGCGGTTTC -> GAAAATCTGATTCGCGCGGTTTCT
TTAATAGTCCACTGCGCCTTGTTG -> TAATAGTCCACTGCGCCTTGTTGG
TACCCTAGCATTTGCGGTTAGATA -> ACCCTAGCATTTGCGGTTAGATAC
AGGCAACAACCGCTCGTCTTAAGA -> GGCAACAACCGCTCGTCTTAAGAA
GGCAACAACCGCTCGTCTTAAGAA -> GCAACAACCGCTCGTCTTAAGAAA
ATAATGTGCGTGGTGCTTCAAACG -> TAATGTGCGTGGTGCTTCAAACGT
AGCCCAATTGTTCGACATTATAGG -> GCCCAATTGTTCGACATTATAGGC
GCACACCGCCTATGGAAAGCATTT -> CACACCGCCTATGGAAAGCATTTG
TAAAGGAGAGAGGCAACAACCGCT -> AAAGGAGAGAGGCAACAACCGCTC
AATCTGATTCGCGCGGTTTCTAAC -> ATCTGATTCGCGCGGTTTCTAACA
GTGAGGAACAATCGGGCGTCCCCA -> TGAGGAACAATCGGGCGTCCCCAT
ACTGAGTTGTAGGCGCTGCATTAA -> CTGAGTTGTAGGCGCTGCATTAAC
TTATTGGGTGACCACGGACGTGTA -> TATTGGGTGACCACGGACGTGTAT
GGCGGTTCGCCTCGCACAATTCAC -> GCGGTTCGCCTCGCACAATTCACT
GGTAGGACTCGGCCTTCACTCTGA -> GTAGGACTCGGCCTTCACTCTGAC
TAAATAGTGCGTGAGATTTCGTGC -> AAATAGTGCGTGAGATTTCGTGCA
GGCCAGTGGCCCTAGCCCAATTGT -> GCCAGTGGCCCTAGCCCAATTGTT
CTAGAACTATGACTGACTCGTCCA -> TAGAACTATGACTGACTCGTCCAA
CCCAGACTTAAAACCAAGGCAAGG -> CCAGACTTAAAACCAAGGCAAGGA
CGCACAATTCACTCTGGTACCATT -> GCACAATTCACTCTGGTACCATTC
TGGAAATATAGGATGTTGGCTCAC -> GGAAATATAGGATGTTGGCTCACG
ATTTCCCCACTTTCTTTTCATGGG -> TTTCCCCACTTTCTTTTCATGGGG
GAAGTAGAGTCTGGGATAGAGTAT -> AAGTAGAGTCTGGGATAGAGTATT
GCATCTCGAGCTATGCGTATAAGC -> CATCTCGAGCTATGCGTATAAGCG
TTCCCCACTTTCTTTTCATGGGGT -> TCCCCACTTTCTTTTCATGGGGTC
AAACGTTTTTATGATCTCGCATCA -> AACGTTTTTATGATCTCGCATCAT
CATCCTCCCTTTCCATAGTTCTGG -> ATCCTCCCTTTCCATAGTTCTGGA
GTCTGGGATAGAGTATTCACCGAC -> TCTGGGATAGAGTATTCACCGACT
TGGTGAAACGTTTTTATGATCTCG -> GGTGAAACGTTTTTATGATCTCGC
GGGATGGCCAGTGGCCCTAGCCCA -> GGATGGCCAGTGGCCCTAGCCCAA
GAAATTCTCAGACGTTGTGAATTA -> AAATTCTCAGACGTTGTGAATTAG
TTCTGCTGGTATTGGGCTTATACC -> TCTGCTGGTATTGGGCTTATACCA
AGTAATGATGGTTCACTCTTTGCC -> GTAATGATGGTTCACTCTTTGCCA
TCAAAACGCCAATGCAAAGACTGG -> CAAAACGCCAATGCAAAGACTGGG
CAAGCCTACTAATGTACGCAGGAC -> AAGCCTACTAATGTACGCAGGACG
GTCCCCATTAGTGTATGGAAATAT -> TCCCCATTAGTGTATGGAAATATA
CACTGTTACAACGGATACCGCCTT -> ACTGTTACAACGGATACCGCCTTG
AACGAAAACGGAGAGGGGTTGGAA -> ACGAAAACGGAGAGGGGTTGGAAC